fecha,nuevas,suspendidas,reingresos,actividad,delta,saldo
2000-01-01,34389,0,0,Todas,0,34389
2000-01-03,10,0,0,Todas,0,34399
2000-01-04,8,0,0,Todas,0,34407
2000-01-05,4,0,0,Todas,0,34411
2000-01-06,3,0,0,Todas,0,34414
2000-01-07,11,0,0,Todas,0,34425
2000-01-09,1,0,0,Todas,0,34426
2000-01-10,8,0,0,Todas,0,34434
2000-01-11,14,0,0,Todas,0,34448
2000-01-12,12,0,0,Todas,0,34460
2000-01-13,11,0,0,Todas,0,34471
2000-01-14,11,0,0,Todas,0,34482
2000-01-15,1,0,0,Todas,0,34483
2000-01-17,8,0,0,Todas,0,34491
2000-01-18,8,0,0,Todas,0,34499
2000-01-19,10,0,0,Todas,0,34509
2000-01-20,8,0,0,Todas,0,34517
2000-01-23,1,0,0,Todas,0,34518
2000-01-24,11,0,0,Todas,0,34529
2000-01-25,18,0,0,Todas,0,34547
2000-01-26,10,0,0,Todas,0,34557
2000-01-27,13,0,0,Todas,0,34570
2000-01-28,14,0,0,Todas,0,34584
2000-01-31,6,0,0,Todas,0,34590
2000-02-01,14,0,0,Todas,0,34604
2000-02-02,11,0,0,Todas,0,34615
2000-02-03,13,0,0,Todas,0,34628
2000-02-04,11,0,0,Todas,0,34639
2000-02-05,1,0,0,Todas,0,34640
2000-02-07,6,0,0,Todas,0,34646
2000-02-08,14,0,0,Todas,0,34660
2000-02-09,10,0,0,Todas,0,34670
2000-02-10,12,0,0,Todas,0,34682
2000-02-11,9,0,0,Todas,0,34691
2000-02-14,13,0,0,Todas,0,34704
2000-02-15,20,0,0,Todas,0,34724
2000-02-16,17,0,0,Todas,0,34741
2000-02-17,8,0,0,Todas,0,34749
2000-02-18,8,0,0,Todas,0,34757
2000-02-21,13,0,0,Todas,0,34770
2000-02-22,20,0,0,Todas,0,34790
2000-02-23,8,0,0,Todas,0,34798
2000-02-24,14,0,0,Todas,0,34812
2000-02-25,13,0,0,Todas,0,34825
2000-02-28,18,0,0,Todas,0,34843
2000-02-29,10,0,0,Todas,0,34853
2000-03-01,11,0,0,Todas,0,34864
2000-03-02,10,0,0,Todas,0,34874
2000-03-03,11,0,0,Todas,0,34885
2000-03-07,1,0,0,Todas,0,34886
2000-03-08,9,0,0,Todas,0,34895
2000-03-09,8,0,0,Todas,0,34903
2000-03-10,18,0,0,Todas,0,34921
2000-03-13,17,0,0,Todas,0,34938
2000-03-14,14,0,0,Todas,0,34952
2000-03-15,13,0,0,Todas,0,34965
2000-03-16,12,0,0,Todas,0,34977
2000-03-17,7,0,0,Todas,0,34984
2000-03-20,14,0,0,Todas,0,34998
2000-03-21,8,0,0,Todas,0,35006
2000-03-22,12,0,0,Todas,0,35018
2000-03-23,12,0,0,Todas,0,35030
2000-03-24,17,0,0,Todas,0,35047
2000-03-27,8,0,0,Todas,0,35055
2000-03-28,12,0,0,Todas,0,35067
2000-03-29,17,0,0,Todas,0,35084
2000-03-30,19,0,0,Todas,0,35103
2000-03-31,15,0,0,Todas,0,35118
2000-04-01,1,0,0,Todas,0,35119
2000-04-03,25,0,0,Todas,0,35144
2000-04-04,16,0,0,Todas,0,35160
2000-04-05,13,0,0,Todas,0,35173
2000-04-06,22,0,0,Todas,0,35195
2000-04-07,8,0,0,Todas,0,35203
2000-04-10,9,0,0,Todas,0,35212
2000-04-11,16,0,0,Todas,0,35228
2000-04-12,7,0,0,Todas,0,35235
2000-04-13,16,0,0,Todas,0,35251
2000-04-14,10,0,0,Todas,0,35261
2000-04-17,16,0,0,Todas,0,35277
2000-04-18,21,0,0,Todas,0,35298
2000-04-19,7,0,0,Todas,0,35305
2000-04-20,5,0,0,Todas,0,35310
2000-04-22,1,0,0,Todas,0,35311
2000-04-24,6,0,0,Todas,0,35317
2000-04-25,9,0,0,Todas,0,35326
2000-04-26,9,0,0,Todas,0,35335
2000-04-27,12,0,0,Todas,0,35347
2000-04-28,15,0,0,Todas,0,35362
2000-04-30,1,0,0,Todas,0,35363
2000-05-02,4,0,0,Todas,0,35367
2000-05-03,18,0,0,Todas,0,35385
2000-05-04,8,0,0,Todas,0,35393
2000-05-05,10,0,0,Todas,0,35403
2000-05-08,10,0,0,Todas,0,35413
2000-05-09,18,0,0,Todas,0,35431
2000-05-10,11,0,0,Todas,0,35442
2000-05-11,16,0,0,Todas,0,35458
2000-05-12,8,0,0,Todas,0,35466
2000-05-15,12,0,0,Todas,0,35478
2000-05-16,11,0,0,Todas,0,35489
2000-05-17,12,0,0,Todas,0,35501
2000-05-18,9,0,0,Todas,0,35510
2000-05-19,11,0,0,Todas,0,35521
2000-05-22,8,0,0,Todas,0,35529
2000-05-23,18,0,0,Todas,0,35547
2000-05-24,19,0,0,Todas,0,35566
2000-05-25,20,0,0,Todas,0,35586
2000-05-29,13,0,0,Todas,0,35599
2000-05-30,12,0,0,Todas,0,35611
2000-05-31,14,0,0,Todas,0,35625
2000-06-01,13,0,0,Todas,0,35638
2000-06-02,18,0,0,Todas,0,35656
2000-06-05,14,0,0,Todas,0,35670
2000-06-06,9,0,0,Todas,0,35679
2000-06-07,14,0,0,Todas,0,35693
2000-06-08,18,0,0,Todas,0,35711
2000-06-09,11,0,0,Todas,0,35722
2000-06-12,14,0,0,Todas,0,35736
2000-06-13,11,0,0,Todas,0,35747
2000-06-14,15,0,0,Todas,0,35762
2000-06-15,15,0,0,Todas,0,35777
2000-06-16,8,0,0,Todas,0,35785
2000-06-19,17,0,0,Todas,0,35802
2000-06-20,15,0,0,Todas,0,35817
2000-06-21,11,0,0,Todas,0,35828
2000-06-22,13,0,0,Todas,0,35841
2000-06-23,10,0,0,Todas,0,35851
2000-06-26,11,0,0,Todas,0,35862
2000-06-27,14,0,0,Todas,0,35876
2000-06-28,13,0,0,Todas,0,35889
2000-06-29,11,0,0,Todas,0,35900
2000-06-30,10,0,0,Todas,0,35910
2000-07-03,15,0,0,Todas,0,35925
2000-07-04,10,0,0,Todas,0,35935
2000-07-05,8,0,0,Todas,0,35943
2000-07-06,17,0,0,Todas,0,35960
2000-07-07,20,0,0,Todas,0,35980
2000-07-10,19,0,0,Todas,0,35999
2000-07-11,11,0,0,Todas,0,36010
2000-07-12,22,0,0,Todas,0,36032
2000-07-13,15,0,0,Todas,0,36047
2000-07-14,12,0,0,Todas,0,36059
2000-07-17,6,0,0,Todas,0,36065
2000-07-18,18,0,0,Todas,0,36083
2000-07-19,7,0,0,Todas,0,36090
2000-07-20,11,0,0,Todas,0,36101
2000-07-21,12,0,0,Todas,0,36113
2000-07-24,19,0,0,Todas,0,36132
2000-07-25,7,0,0,Todas,0,36139
2000-07-26,16,0,0,Todas,0,36155
2000-07-27,14,0,0,Todas,0,36169
2000-07-28,12,0,0,Todas,0,36181
2000-07-31,13,0,0,Todas,0,36194
2000-08-01,15,0,0,Todas,0,36209
2000-08-02,18,0,0,Todas,0,36227
2000-08-03,21,0,0,Todas,0,36248
2000-08-04,2,0,0,Todas,0,36250
2000-08-05,2,0,0,Todas,0,36252
2000-08-07,14,0,0,Todas,0,36266
2000-08-08,13,0,0,Todas,0,36279
2000-08-09,9,0,0,Todas,0,36288
2000-08-10,20,0,0,Todas,0,36308
2000-08-11,12,0,0,Todas,0,36320
2000-08-14,12,0,0,Todas,0,36332
2000-08-15,14,0,0,Todas,0,36346
2000-08-16,15,0,0,Todas,0,36361
2000-08-17,19,0,0,Todas,0,36380
2000-08-18,14,0,0,Todas,0,36394
2000-08-21,11,0,0,Todas,0,36405
2000-08-22,11,0,0,Todas,0,36416
2000-08-23,23,0,0,Todas,0,36439
2000-08-24,6,0,0,Todas,0,36445
2000-08-25,8,0,0,Todas,0,36453
2000-08-28,14,0,0,Todas,0,36467
2000-08-29,8,0,0,Todas,0,36475
2000-08-30,12,0,0,Todas,0,36487
2000-08-31,9,0,0,Todas,0,36496
2000-09-01,11,0,0,Todas,0,36507
2000-09-04,12,0,0,Todas,0,36519
2000-09-05,20,0,0,Todas,0,36539
2000-09-06,9,0,0,Todas,0,36548
2000-09-07,9,0,0,Todas,0,36557
2000-09-08,12,0,0,Todas,0,36569
2000-09-11,19,0,0,Todas,0,36588
2000-09-12,12,0,0,Todas,0,36600
2000-09-13,15,0,0,Todas,0,36615
2000-09-14,11,0,0,Todas,0,36626
2000-09-15,11,0,0,Todas,0,36637
2000-09-16,1,0,0,Todas,0,36638
2000-09-18,13,0,0,Todas,0,36651
2000-09-19,22,0,0,Todas,0,36673
2000-09-20,19,0,0,Todas,0,36692
2000-09-21,14,0,0,Todas,0,36706
2000-09-22,16,0,0,Todas,0,36722
2000-09-25,11,0,0,Todas,0,36733
2000-09-26,12,0,0,Todas,0,36745
2000-09-27,11,0,0,Todas,0,36756
2000-09-28,15,0,0,Todas,0,36771
2000-09-29,11,0,0,Todas,0,36782
2000-10-01,1,0,0,Todas,0,36783
2000-10-02,10,0,0,Todas,0,36793
2000-10-03,11,0,0,Todas,0,36804
2000-10-04,16,0,0,Todas,0,36820
2000-10-05,12,0,0,Todas,0,36832
2000-10-06,11,0,0,Todas,0,36843
2000-10-10,9,0,0,Todas,0,36852
2000-10-11,15,0,0,Todas,0,36867
2000-10-12,11,0,0,Todas,0,36878
2000-10-13,12,0,0,Todas,0,36890
2000-10-15,1,0,0,Todas,0,36891
2000-10-16,8,0,0,Todas,0,36899
2000-10-17,10,0,0,Todas,0,36909
2000-10-18,8,0,0,Todas,0,36917
2000-10-19,13,0,0,Todas,0,36930
2000-10-20,14,0,0,Todas,0,36944
2000-10-23,13,0,0,Todas,0,36957
2000-10-24,12,0,0,Todas,0,36969
2000-10-25,11,0,0,Todas,0,36980
2000-10-26,7,0,0,Todas,0,36987
2000-10-27,33,0,0,Todas,0,37020
2000-10-30,16,0,0,Todas,0,37036
2000-10-31,9,0,0,Todas,0,37045
2000-11-01,13,0,0,Todas,0,37058
2000-11-06,3,0,0,Todas,0,37061
2000-11-07,11,0,0,Todas,0,37072
2000-11-08,8,0,0,Todas,0,37080
2000-11-09,12,0,0,Todas,0,37092
2000-11-10,12,0,0,Todas,0,37104
2000-11-13,15,0,0,Todas,0,37119
2000-11-14,12,0,0,Todas,0,37131
2000-11-15,11,0,0,Todas,0,37142
2000-11-16,10,0,0,Todas,0,37152
2000-11-17,7,0,0,Todas,0,37159
2000-11-20,6,0,0,Todas,0,37165
2000-11-21,8,0,0,Todas,0,37173
2000-11-22,9,0,0,Todas,0,37182
2000-11-23,9,0,0,Todas,0,37191
2000-11-24,11,0,0,Todas,0,37202
2000-11-26,1,0,0,Todas,0,37203
2000-11-27,12,0,0,Todas,0,37215
2000-11-28,10,0,0,Todas,0,37225
2000-11-29,8,0,0,Todas,0,37233
2000-11-30,15,0,0,Todas,0,37248
2000-12-01,14,0,0,Todas,0,37262
2000-12-04,12,0,0,Todas,0,37274
2000-12-05,5,0,0,Todas,0,37279
2000-12-07,16,0,0,Todas,0,37295
2000-12-08,10,0,0,Todas,0,37305
2000-12-11,14,0,0,Todas,0,37319
2000-12-12,14,0,0,Todas,0,37333
2000-12-13,14,0,0,Todas,0,37347
2000-12-14,8,0,0,Todas,0,37355
2000-12-15,16,0,0,Todas,0,37371
2000-12-18,11,0,0,Todas,0,37382
2000-12-19,14,0,0,Todas,0,37396
2000-12-20,12,0,0,Todas,0,37408
2000-12-21,5,0,0,Todas,0,37413
2000-12-22,5,0,0,Todas,0,37418
2000-12-26,7,0,0,Todas,0,37425
2000-12-27,9,0,0,Todas,0,37434
2000-12-28,8,0,0,Todas,0,37442
2000-12-29,8,0,0,Todas,0,37450
2001-01-01,1,0,0,Todas,0,37451
2001-01-02,7,0,0,Todas,0,37458
2001-01-03,13,0,0,Todas,0,37471
2001-01-04,6,0,0,Todas,0,37477
2001-01-05,12,0,0,Todas,0,37489
2001-01-08,14,0,0,Todas,0,37503
2001-01-09,7,0,0,Todas,0,37510
2001-01-10,11,0,0,Todas,0,37521
2001-01-11,14,0,0,Todas,0,37535
2001-01-12,14,0,0,Todas,0,37549
2001-01-15,12,0,0,Todas,0,37561
2001-01-16,17,0,0,Todas,0,37578
2001-01-17,10,0,0,Todas,0,37588
2001-01-18,7,0,0,Todas,0,37595
2001-01-19,10,0,0,Todas,0,37605
2001-01-21,3,0,0,Todas,0,37608
2001-01-22,22,0,0,Todas,0,37630
2001-01-23,14,0,0,Todas,0,37644
2001-01-24,7,0,0,Todas,0,37651
2001-01-25,19,0,0,Todas,0,37670
2001-01-26,9,0,0,Todas,0,37679
2001-01-29,15,0,0,Todas,0,37694
2001-01-30,9,0,0,Todas,0,37703
2001-01-31,26,0,0,Todas,0,37729
2001-02-01,16,0,0,Todas,0,37745
2001-02-02,14,0,0,Todas,0,37759
2001-02-05,4,0,0,Todas,0,37763
2001-02-06,12,0,0,Todas,0,37775
2001-02-07,13,0,0,Todas,0,37788
2001-02-08,14,0,0,Todas,0,37802
2001-02-09,19,0,0,Todas,0,37821
2001-02-12,14,0,0,Todas,0,37835
2001-02-13,4,0,0,Todas,0,37839
2001-02-14,10,0,0,Todas,0,37849
2001-02-15,11,0,0,Todas,0,37860
2001-02-16,9,0,0,Todas,0,37869
2001-02-18,2,0,0,Todas,0,37871
2001-02-19,7,0,0,Todas,0,37878
2001-02-20,10,0,0,Todas,0,37888
2001-02-21,17,0,0,Todas,0,37905
2001-02-22,20,0,0,Todas,0,37925
2001-02-23,15,0,0,Todas,0,37940
2001-02-25,1,0,0,Todas,0,37941
2001-02-28,17,0,0,Todas,0,37958
2001-03-01,8,0,0,Todas,0,37966
2001-03-02,15,0,0,Todas,0,37981
2001-03-05,15,0,0,Todas,0,37996
2001-03-06,7,0,0,Todas,0,38003
2001-03-07,8,0,0,Todas,0,38011
2001-03-08,16,0,0,Todas,0,38027
2001-03-09,16,0,0,Todas,0,38043
2001-03-12,13,0,0,Todas,0,38056
2001-03-13,14,0,0,Todas,0,38070
2001-03-14,14,0,0,Todas,0,38084
2001-03-15,19,0,0,Todas,0,38103
2001-03-16,16,0,0,Todas,0,38119
2001-03-19,20,0,0,Todas,0,38139
2001-03-20,28,0,0,Todas,0,38167
2001-03-21,15,0,0,Todas,0,38182
2001-03-22,24,0,0,Todas,0,38206
2001-03-23,14,0,0,Todas,0,38220
2001-03-26,10,0,0,Todas,0,38230
2001-03-27,12,0,0,Todas,0,38242
2001-03-28,7,0,0,Todas,0,38249
2001-03-29,25,0,0,Todas,0,38274
2001-03-30,17,0,0,Todas,0,38291
2001-04-01,2,0,0,Todas,0,38293
2001-04-02,10,0,0,Todas,0,38303
2001-04-03,13,0,0,Todas,0,38316
2001-04-04,17,0,0,Todas,0,38333
2001-04-05,18,0,0,Todas,0,38351
2001-04-06,18,0,0,Todas,0,38369
2001-04-07,1,0,0,Todas,0,38370
2001-04-08,1,0,0,Todas,0,38371
2001-04-09,7,0,0,Todas,0,38378
2001-04-10,10,0,0,Todas,0,38388
2001-04-11,9,0,0,Todas,0,38397
2001-04-12,9,0,0,Todas,0,38406
2001-04-13,1,0,0,Todas,0,38407
2001-04-16,11,0,0,Todas,0,38418
2001-04-17,14,0,0,Todas,0,38432
2001-04-18,19,0,0,Todas,0,38451
2001-04-19,11,0,0,Todas,0,38462
2001-04-20,12,0,0,Todas,0,38474
2001-04-23,16,0,0,Todas,0,38490
2001-04-24,10,0,0,Todas,0,38500
2001-04-25,16,0,0,Todas,0,38516
2001-04-26,8,0,0,Todas,0,38524
2001-04-27,12,0,0,Todas,0,38536
2001-04-30,15,0,0,Todas,0,38551
2001-05-01,1,0,0,Todas,0,38552
2001-05-02,18,0,0,Todas,0,38570
2001-05-03,16,0,0,Todas,0,38586
2001-05-04,9,0,0,Todas,0,38595
2001-05-05,1,0,0,Todas,0,38596
2001-05-07,14,0,0,Todas,0,38610
2001-05-08,7,0,0,Todas,0,38617
2001-05-09,12,0,0,Todas,0,38629
2001-05-10,15,0,0,Todas,0,38644
2001-05-11,19,0,0,Todas,0,38663
2001-05-14,23,0,0,Todas,0,38686
2001-05-15,12,0,0,Todas,0,38698
2001-05-16,23,0,0,Todas,0,38721
2001-05-17,13,0,0,Todas,0,38734
2001-05-18,12,0,0,Todas,0,38746
2001-05-21,10,0,0,Todas,0,38756
2001-05-22,16,0,0,Todas,0,38772
2001-05-23,11,0,0,Todas,0,38783
2001-05-24,11,0,0,Todas,0,38794
2001-05-28,11,0,0,Todas,0,38805
2001-05-29,22,0,0,Todas,0,38827
2001-05-30,9,0,0,Todas,0,38836
2001-05-31,25,0,0,Todas,0,38861
2001-06-01,20,0,0,Todas,0,38881
2001-06-03,1,0,0,Todas,0,38882
2001-06-04,20,0,0,Todas,0,38902
2001-06-05,11,0,0,Todas,0,38913
2001-06-06,16,0,0,Todas,0,38929
2001-06-07,7,0,0,Todas,0,38936
2001-06-08,11,0,0,Todas,0,38947
2001-06-10,1,0,0,Todas,0,38948
2001-06-11,13,0,0,Todas,0,38961
2001-06-12,12,0,0,Todas,0,38973
2001-06-13,14,0,0,Todas,0,38987
2001-06-14,8,0,0,Todas,0,38995
2001-06-15,5,0,0,Todas,0,39000
2001-06-18,12,0,0,Todas,0,39012
2001-06-19,17,0,0,Todas,0,39029
2001-06-20,12,0,0,Todas,0,39041
2001-06-21,19,0,0,Todas,0,39060
2001-06-22,11,0,0,Todas,0,39071
2001-06-25,25,0,0,Todas,0,39096
2001-06-26,16,0,0,Todas,0,39112
2001-06-27,19,0,0,Todas,0,39131
2001-06-28,15,0,0,Todas,0,39146
2001-06-29,13,0,0,Todas,0,39159
2001-07-01,1,0,0,Todas,0,39160
2001-07-02,11,0,0,Todas,0,39171
2001-07-03,16,0,0,Todas,0,39187
2001-07-04,18,0,0,Todas,0,39205
2001-07-05,16,0,0,Todas,0,39221
2001-07-06,10,0,0,Todas,0,39231
2001-07-09,11,0,0,Todas,0,39242
2001-07-10,26,0,0,Todas,0,39268
2001-07-11,20,0,0,Todas,0,39288
2001-07-12,13,0,0,Todas,0,39301
2001-07-13,14,0,0,Todas,0,39315
2001-07-16,12,0,0,Todas,0,39327
2001-07-17,16,0,0,Todas,0,39343
2001-07-18,6,0,0,Todas,0,39349
2001-07-19,13,0,0,Todas,0,39362
2001-07-20,25,0,0,Todas,0,39387
2001-07-23,12,0,0,Todas,0,39399
2001-07-24,15,0,0,Todas,0,39414
2001-07-25,15,0,0,Todas,0,39429
2001-07-26,10,0,0,Todas,0,39439
2001-07-27,10,0,0,Todas,0,39449
2001-07-30,15,0,0,Todas,0,39464
2001-07-31,12,0,0,Todas,0,39476
2001-08-01,17,0,0,Todas,0,39493
2001-08-02,28,0,0,Todas,0,39521
2001-08-03,13,0,0,Todas,0,39534
2001-08-05,1,0,0,Todas,0,39535
2001-08-06,10,0,0,Todas,0,39545
2001-08-07,15,0,0,Todas,0,39560
2001-08-08,3,0,0,Todas,0,39563
2001-08-09,2,0,0,Todas,0,39565
2001-08-13,5,0,0,Todas,0,39570
2001-08-14,15,0,0,Todas,0,39585
2001-08-15,13,0,0,Todas,0,39598
2001-08-16,9,0,0,Todas,0,39607
2001-08-17,8,0,0,Todas,0,39615
2001-08-20,13,0,0,Todas,0,39628
2001-08-21,18,0,0,Todas,0,39646
2001-08-22,15,0,0,Todas,0,39661
2001-08-23,14,0,0,Todas,0,39675
2001-08-24,20,0,0,Todas,0,39695
2001-08-27,16,0,0,Todas,0,39711
2001-08-28,28,0,0,Todas,0,39739
2001-08-29,9,0,0,Todas,0,39748
2001-08-30,10,0,0,Todas,0,39758
2001-08-31,7,0,0,Todas,0,39765
2001-09-03,13,0,0,Todas,0,39778
2001-09-04,9,0,0,Todas,0,39787
2001-09-05,21,0,0,Todas,0,39808
2001-09-06,18,0,0,Todas,0,39826
2001-09-07,20,0,0,Todas,0,39846
2001-09-10,11,0,0,Todas,0,39857
2001-09-11,10,0,0,Todas,0,39867
2001-09-12,16,0,0,Todas,0,39883
2001-09-13,19,0,0,Todas,0,39902
2001-09-14,13,0,0,Todas,0,39915
2001-09-16,1,0,0,Todas,0,39916
2001-09-17,22,0,0,Todas,0,39938
2001-09-18,18,0,0,Todas,0,39956
2001-09-19,16,0,0,Todas,0,39972
2001-09-20,20,0,0,Todas,0,39992
2001-09-21,12,0,0,Todas,0,40004
2001-09-24,19,0,0,Todas,0,40023
2001-09-25,10,0,0,Todas,0,40033
2001-09-26,14,0,0,Todas,0,40047
2001-09-27,17,0,0,Todas,0,40064
2001-09-28,11,0,0,Todas,0,40075
2001-10-01,23,0,0,Todas,0,40098
2001-10-02,15,0,0,Todas,0,40113
2001-10-03,8,0,0,Todas,0,40121
2001-10-04,11,0,0,Todas,0,40132
2001-10-05,9,0,0,Todas,0,40141
2001-10-07,1,0,0,Todas,0,40142
2001-10-08,13,0,0,Todas,0,40155
2001-10-09,1,0,0,Todas,0,40156
2001-10-10,13,0,0,Todas,0,40169
2001-10-11,9,0,0,Todas,0,40178
2001-10-12,11,0,0,Todas,0,40189
2001-10-14,1,0,0,Todas,0,40190
2001-10-15,12,0,0,Todas,0,40202
2001-10-16,12,0,0,Todas,0,40214
2001-10-17,11,0,0,Todas,0,40225
2001-10-18,11,0,0,Todas,0,40236
2001-10-19,7,0,0,Todas,0,40243
2001-10-22,12,0,0,Todas,0,40255
2001-10-23,13,0,0,Todas,0,40268
2001-10-24,13,0,0,Todas,0,40281
2001-10-25,15,0,0,Todas,0,40296
2001-10-26,15,0,0,Todas,0,40311
2001-10-29,13,0,0,Todas,0,40324
2001-10-30,13,0,0,Todas,0,40337
2001-10-31,17,0,0,Todas,0,40354
2001-11-01,17,0,0,Todas,0,40371
2001-11-05,16,0,0,Todas,0,40387
2001-11-06,12,0,0,Todas,0,40399
2001-11-07,10,0,0,Todas,0,40409
2001-11-08,11,0,0,Todas,0,40420
2001-11-09,9,0,0,Todas,0,40429
2001-11-11,1,0,0,Todas,0,40430
2001-11-12,13,0,0,Todas,0,40443
2001-11-13,11,0,0,Todas,0,40454
2001-11-14,12,0,0,Todas,0,40466
2001-11-15,1,0,0,Todas,0,40467
2001-11-16,13,0,0,Todas,0,40480
2001-11-19,12,0,0,Todas,0,40492
2001-11-20,17,0,0,Todas,0,40509
2001-11-21,13,0,0,Todas,0,40522
2001-11-22,19,0,0,Todas,0,40541
2001-11-23,6,0,0,Todas,0,40547
2001-11-25,1,0,0,Todas,0,40548
2001-11-26,15,0,0,Todas,0,40563
2001-11-27,13,0,0,Todas,0,40576
2001-11-28,16,0,0,Todas,0,40592
2001-11-29,17,0,0,Todas,0,40609
2001-11-30,8,0,0,Todas,0,40617
2001-12-03,14,0,0,Todas,0,40631
2001-12-04,11,0,0,Todas,0,40642
2001-12-05,10,0,0,Todas,0,40652
2001-12-06,2,0,0,Todas,0,40654
2001-12-07,7,0,0,Todas,0,40661
2001-12-10,12,0,0,Todas,0,40673
2001-12-11,6,0,0,Todas,0,40679
2001-12-12,7,0,0,Todas,0,40686
2001-12-13,6,0,0,Todas,0,40692
2001-12-14,9,0,0,Todas,0,40701
2001-12-17,16,0,0,Todas,0,40717
2001-12-18,10,0,0,Todas,0,40727
2001-12-19,9,0,0,Todas,0,40736
2001-12-20,11,0,0,Todas,0,40747
2001-12-21,11,0,0,Todas,0,40758
2001-12-24,7,0,0,Todas,0,40765
2001-12-26,9,0,0,Todas,0,40774
2001-12-27,8,0,0,Todas,0,40782
2001-12-28,17,0,0,Todas,0,40799
2001-12-31,1,0,0,Todas,0,40800
2002-01-01,79,0,0,Todas,0,40879
2002-01-02,11,0,0,Todas,0,40890
2002-01-03,12,0,0,Todas,0,40902
2002-01-04,9,0,0,Todas,0,40911
2002-01-07,11,0,0,Todas,0,40922
2002-01-08,9,0,0,Todas,0,40931
2002-01-09,12,0,0,Todas,0,40943
2002-01-10,8,0,0,Todas,0,40951
2002-01-11,11,0,0,Todas,0,40962
2002-01-14,7,0,0,Todas,0,40969
2002-01-15,11,0,0,Todas,0,40980
2002-01-16,11,0,0,Todas,0,40991
2002-01-17,13,0,0,Todas,0,41004
2002-01-18,9,0,0,Todas,0,41013
2002-01-21,13,0,0,Todas,0,41026
2002-01-22,14,0,0,Todas,0,41040
2002-01-23,11,0,0,Todas,0,41051
2002-01-24,5,0,0,Todas,0,41056
2002-01-25,6,0,0,Todas,0,41062
2002-01-28,10,0,0,Todas,0,41072
2002-01-29,21,0,0,Todas,0,41093
2002-01-30,11,0,0,Todas,0,41104
2002-01-31,15,0,0,Todas,0,41119
2002-02-01,18,0,0,Todas,0,41137
2002-02-04,5,0,0,Todas,0,41142
2002-02-05,9,0,0,Todas,0,41151
2002-02-06,13,0,0,Todas,0,41164
2002-02-07,13,0,0,Todas,0,41177
2002-02-08,10,0,0,Todas,0,41187
2002-02-13,12,0,0,Todas,0,41199
2002-02-14,13,0,0,Todas,0,41212
2002-02-15,14,0,0,Todas,0,41226
2002-02-18,12,0,0,Todas,0,41238
2002-02-19,12,0,0,Todas,0,41250
2002-02-20,12,0,0,Todas,0,41262
2002-02-21,17,0,0,Todas,0,41279
2002-02-22,5,0,0,Todas,0,41284
2002-02-25,13,0,0,Todas,0,41297
2002-02-26,11,0,0,Todas,0,41308
2002-02-27,12,0,0,Todas,0,41320
2002-02-28,17,0,0,Todas,0,41337
2002-03-01,11,0,0,Todas,0,41348
2002-03-02,1,0,0,Todas,0,41349
2002-03-04,13,0,0,Todas,0,41362
2002-03-05,15,0,0,Todas,0,41377
2002-03-06,20,0,0,Todas,0,41397
2002-03-07,10,0,0,Todas,0,41407
2002-03-08,12,0,0,Todas,0,41419
2002-03-09,1,0,0,Todas,0,41420
2002-03-11,13,0,0,Todas,0,41433
2002-03-12,14,0,0,Todas,0,41447
2002-03-13,15,0,0,Todas,0,41462
2002-03-14,14,0,0,Todas,0,41476
2002-03-15,7,0,0,Todas,0,41483
2002-03-18,9,0,0,Todas,0,41492
2002-03-19,8,0,0,Todas,0,41500
2002-03-20,12,0,0,Todas,0,41512
2002-03-21,10,0,0,Todas,0,41522
2002-03-22,8,0,0,Todas,0,41530
2002-03-23,1,0,0,Todas,0,41531
2002-03-25,17,0,0,Todas,0,41548
2002-03-26,12,0,0,Todas,0,41560
2002-03-27,14,0,0,Todas,0,41574
2002-03-28,7,0,0,Todas,0,41581
2002-04-01,17,0,0,Todas,0,41598
2002-04-02,10,0,0,Todas,0,41608
2002-04-03,13,0,0,Todas,0,41621
2002-04-04,15,0,0,Todas,0,41636
2002-04-05,16,0,0,Todas,0,41652
2002-04-08,19,0,0,Todas,0,41671
2002-04-09,12,0,0,Todas,0,41683
2002-04-10,20,0,0,Todas,0,41703
2002-04-11,17,0,0,Todas,0,41720
2002-04-12,9,0,0,Todas,0,41729
2002-04-15,7,0,0,Todas,0,41736
2002-04-16,9,0,0,Todas,0,41745
2002-04-18,21,0,0,Todas,0,41766
2002-04-19,15,0,0,Todas,0,41781
2002-04-22,10,0,0,Todas,0,41791
2002-04-23,10,0,0,Todas,0,41801
2002-04-24,11,0,0,Todas,0,41812
2002-04-25,16,0,0,Todas,0,41828
2002-04-26,12,0,0,Todas,0,41840
2002-04-29,9,0,0,Todas,0,41849
2002-04-30,15,0,0,Todas,0,41864
2002-05-02,12,0,0,Todas,0,41876
2002-05-03,10,0,0,Todas,0,41886
2002-05-06,11,0,0,Todas,0,41897
2002-05-07,13,0,0,Todas,0,41910
2002-05-08,11,0,0,Todas,0,41921
2002-05-09,16,0,0,Todas,0,41937
2002-05-10,15,0,0,Todas,0,41952
2002-05-13,13,0,0,Todas,0,41965
2002-05-14,11,0,0,Todas,0,41976
2002-05-15,15,0,0,Todas,0,41991
2002-05-16,13,0,0,Todas,0,42004
2002-05-17,11,0,0,Todas,0,42015
2002-05-20,6,0,0,Todas,0,42021
2002-05-21,16,0,0,Todas,0,42037
2002-05-22,13,0,0,Todas,0,42050
2002-05-23,18,0,0,Todas,0,42068
2002-05-27,10,0,0,Todas,0,42078
2002-05-28,13,0,0,Todas,0,42091
2002-05-29,6,0,0,Todas,0,42097
2002-05-30,15,0,0,Todas,0,42112
2002-05-31,7,0,0,Todas,0,42119
2002-06-01,3,0,0,Todas,0,42122
2002-06-03,15,0,0,Todas,0,42137
2002-06-04,13,0,0,Todas,0,42150
2002-06-05,7,0,0,Todas,0,42157
2002-06-06,17,0,0,Todas,0,42174
2002-06-07,10,0,0,Todas,0,42184
2002-06-09,1,0,0,Todas,0,42185
2002-06-10,9,0,0,Todas,0,42194
2002-06-11,19,0,0,Todas,0,42213
2002-06-12,12,0,0,Todas,0,42225
2002-06-13,10,0,0,Todas,0,42235
2002-06-14,10,0,0,Todas,0,42245
2002-06-16,1,0,0,Todas,0,42246
2002-06-17,13,0,0,Todas,0,42259
2002-06-18,8,0,0,Todas,0,42267
2002-06-19,20,0,0,Todas,0,42287
2002-06-20,6,0,0,Todas,0,42293
2002-06-21,8,0,0,Todas,0,42301
2002-06-23,1,0,0,Todas,0,42302
2002-06-24,17,0,0,Todas,0,42319
2002-06-25,16,0,0,Todas,0,42335
2002-06-26,7,0,0,Todas,0,42342
2002-06-27,8,0,0,Todas,0,42350
2002-06-28,9,0,0,Todas,0,42359
2002-07-01,15,0,0,Todas,0,42374
2002-07-02,10,0,0,Todas,0,42384
2002-07-03,13,0,0,Todas,0,42397
2002-07-04,8,0,0,Todas,0,42405
2002-07-05,17,0,0,Todas,0,42422
2002-07-08,7,0,0,Todas,0,42429
2002-07-09,6,0,0,Todas,0,42435
2002-07-10,10,0,0,Todas,0,42445
2002-07-11,13,0,0,Todas,0,42458
2002-07-12,19,0,0,Todas,0,42477
2002-07-15,14,0,0,Todas,0,42491
2002-07-16,11,0,0,Todas,0,42502
2002-07-17,12,0,0,Todas,0,42514
2002-07-18,7,0,0,Todas,0,42521
2002-07-19,15,0,0,Todas,0,42536
2002-07-22,10,0,0,Todas,0,42546
2002-07-23,7,0,0,Todas,0,42553
2002-07-24,10,0,0,Todas,0,42563
2002-07-25,12,0,0,Todas,0,42575
2002-07-26,12,0,0,Todas,0,42587
2002-07-29,17,0,0,Todas,0,42604
2002-07-30,14,0,0,Todas,0,42618
2002-07-31,20,0,0,Todas,0,42638
2002-08-01,8,0,0,Todas,0,42646
2002-08-02,13,0,0,Todas,0,42659
2002-08-05,9,0,0,Todas,0,42668
2002-08-06,20,0,0,Todas,0,42688
2002-08-07,13,0,0,Todas,0,42701
2002-08-08,18,0,0,Todas,0,42719
2002-08-09,14,0,0,Todas,0,42733
2002-08-12,10,0,0,Todas,0,42743
2002-08-13,19,0,0,Todas,0,42762
2002-08-14,12,0,0,Todas,0,42774
2002-08-15,11,0,0,Todas,0,42785
2002-08-16,16,0,0,Todas,0,42801
2002-08-19,4,0,0,Todas,0,42805
2002-08-20,10,0,0,Todas,0,42815
2002-08-21,9,0,0,Todas,0,42824
2002-08-22,6,0,0,Todas,0,42830
2002-08-23,8,0,0,Todas,0,42838
2002-08-26,6,0,0,Todas,0,42844
2002-08-27,11,0,0,Todas,0,42855
2002-08-28,19,0,0,Todas,0,42874
2002-08-29,15,0,0,Todas,0,42889
2002-08-30,9,0,0,Todas,0,42898
2002-09-01,1,0,0,Todas,0,42899
2002-09-02,12,0,0,Todas,0,42911
2002-09-03,17,0,0,Todas,0,42928
2002-09-04,19,0,0,Todas,0,42947
2002-09-05,8,0,0,Todas,0,42955
2002-09-06,9,0,0,Todas,0,42964
2002-09-09,15,0,0,Todas,0,42979
2002-09-10,16,0,0,Todas,0,42995
2002-09-11,13,0,0,Todas,0,43008
2002-09-12,13,0,0,Todas,0,43021
2002-09-13,14,0,0,Todas,0,43035
2002-09-14,1,0,0,Todas,0,43036
2002-09-16,11,0,0,Todas,0,43047
2002-09-17,11,0,0,Todas,0,43058
2002-09-18,6,0,0,Todas,0,43064
2002-09-19,12,0,0,Todas,0,43076
2002-09-20,9,0,0,Todas,0,43085
2002-09-23,15,0,0,Todas,0,43100
2002-09-24,11,0,0,Todas,0,43111
2002-09-25,17,0,0,Todas,0,43128
2002-09-26,25,0,0,Todas,0,43153
2002-09-27,10,0,0,Todas,0,43163
2002-09-28,1,0,0,Todas,0,43164
2002-09-30,6,0,0,Todas,0,43170
2002-10-01,15,0,0,Todas,0,43185
2002-10-02,10,0,0,Todas,0,43195
2002-10-03,7,0,0,Todas,0,43202
2002-10-04,17,0,0,Todas,0,43219
2002-10-07,11,0,0,Todas,0,43230
2002-10-08,8,0,0,Todas,0,43238
2002-10-10,10,0,0,Todas,0,43248
2002-10-11,10,0,0,Todas,0,43258
2002-10-14,9,0,0,Todas,0,43267
2002-10-15,7,0,0,Todas,0,43274
2002-10-16,14,0,0,Todas,0,43288
2002-10-17,16,0,0,Todas,0,43304
2002-10-18,6,0,0,Todas,0,43310
2002-10-21,10,0,0,Todas,0,43320
2002-10-22,16,0,0,Todas,0,43336
2002-10-23,13,0,0,Todas,0,43349
2002-10-24,11,0,0,Todas,0,43360
2002-10-25,4,0,0,Todas,0,43364
2002-10-28,8,0,0,Todas,0,43372
2002-10-29,10,0,0,Todas,0,43382
2002-10-30,15,0,0,Todas,0,43397
2002-10-31,7,0,0,Todas,0,43404
2002-11-01,1,0,0,Todas,0,43405
2002-11-04,3,0,0,Todas,0,43408
2002-11-05,5,0,0,Todas,0,43413
2002-11-06,12,0,0,Todas,0,43425
2002-11-07,8,0,0,Todas,0,43433
2002-11-08,17,0,0,Todas,0,43450
2002-11-11,12,0,0,Todas,0,43462
2002-11-12,15,0,0,Todas,0,43477
2002-11-13,12,0,0,Todas,0,43489
2002-11-14,7,0,0,Todas,0,43496
2002-11-15,17,0,0,Todas,0,43513
2002-11-18,14,0,0,Todas,0,43527
2002-11-19,13,0,0,Todas,0,43540
2002-11-20,16,0,0,Todas,0,43556
2002-11-21,14,0,0,Todas,0,43570
2002-11-22,5,0,0,Todas,0,43575
2002-11-24,1,0,0,Todas,0,43576
2002-11-25,13,0,0,Todas,0,43589
2002-11-26,6,0,0,Todas,0,43595
2002-11-27,12,0,0,Todas,0,43607
2002-11-28,7,0,0,Todas,0,43614
2002-11-29,4,0,0,Todas,0,43618
2002-12-02,12,0,0,Todas,0,43630
2002-12-03,12,0,0,Todas,0,43642
2002-12-04,8,0,0,Todas,0,43650
2002-12-05,8,0,0,Todas,0,43658
2002-12-09,3,0,0,Todas,0,43661
2002-12-10,10,0,0,Todas,0,43671
2002-12-11,14,0,0,Todas,0,43685
2002-12-12,9,0,0,Todas,0,43694
2002-12-13,12,0,0,Todas,0,43706
2002-12-16,7,0,0,Todas,0,43713
2002-12-17,10,0,0,Todas,0,43723
2002-12-18,10,0,0,Todas,0,43733
2002-12-19,14,0,0,Todas,0,43747
2002-12-20,12,0,0,Todas,0,43759
2002-12-23,11,0,0,Todas,0,43770
2002-12-24,2,0,0,Todas,0,43772
2002-12-26,9,0,0,Todas,0,43781
2002-12-27,9,0,0,Todas,0,43790
2002-12-30,8,0,0,Todas,0,43798
2002-12-31,4,0,0,Todas,0,43802
2003-01-01,3,0,0,Todas,0,43805
2003-01-02,11,0,0,Todas,0,43816
2003-01-03,9,0,0,Todas,0,43825
2003-01-04,1,0,0,Todas,0,43826
2003-01-05,3,0,0,Todas,0,43829
2003-01-06,8,0,0,Todas,0,43837
2003-01-07,18,0,0,Todas,0,43855
2003-01-08,13,0,0,Todas,0,43868
2003-01-09,8,0,0,Todas,0,43876
2003-01-10,12,0,0,Todas,0,43888
2003-01-13,12,0,0,Todas,0,43900
2003-01-14,17,0,0,Todas,0,43917
2003-01-15,7,0,0,Todas,0,43924
2003-01-16,9,0,0,Todas,0,43933
2003-01-17,8,0,0,Todas,0,43941
2003-01-20,15,0,0,Todas,0,43956
2003-01-21,8,0,0,Todas,0,43964
2003-01-22,10,0,0,Todas,0,43974
2003-01-23,10,0,0,Todas,0,43984
2003-01-24,16,0,0,Todas,0,44000
2003-01-26,1,0,0,Todas,0,44001
2003-01-27,14,0,0,Todas,0,44015
2003-01-28,9,0,0,Todas,0,44024
2003-01-29,9,0,0,Todas,0,44033
2003-01-30,12,0,0,Todas,0,44045
2003-01-31,7,0,0,Todas,0,44052
2003-02-01,2,0,0,Todas,0,44054
2003-02-03,6,0,0,Todas,0,44060
2003-02-04,12,0,0,Todas,0,44072
2003-02-05,9,0,0,Todas,0,44081
2003-02-06,9,0,0,Todas,0,44090
2003-02-07,4,0,0,Todas,0,44094
2003-02-10,14,0,0,Todas,0,44108
2003-02-11,7,0,0,Todas,0,44115
2003-02-12,10,0,0,Todas,0,44125
2003-02-13,3,0,0,Todas,0,44128
2003-02-14,7,0,0,Todas,0,44135
2003-02-17,6,0,0,Todas,0,44141
2003-02-18,13,0,0,Todas,0,44154
2003-02-19,12,0,0,Todas,0,44166
2003-02-20,12,0,0,Todas,0,44178
2003-02-21,10,0,0,Todas,0,44188
2003-02-22,1,0,0,Todas,0,44189
2003-02-24,17,0,0,Todas,0,44206
2003-02-25,8,0,0,Todas,0,44214
2003-02-26,11,0,0,Todas,0,44225
2003-02-27,7,0,0,Todas,0,44232
2003-02-28,7,0,0,Todas,0,44239
2003-03-01,1,0,0,Todas,0,44240
2003-03-03,1,0,0,Todas,0,44241
2003-03-05,8,0,0,Todas,0,44249
2003-03-06,8,0,0,Todas,0,44257
2003-03-07,7,0,0,Todas,0,44264
2003-03-09,1,0,0,Todas,0,44265
2003-03-10,5,0,0,Todas,0,44270
2003-03-11,15,0,0,Todas,0,44285
2003-03-12,14,0,0,Todas,0,44299
2003-03-13,17,0,0,Todas,0,44316
2003-03-14,10,0,0,Todas,0,44326
2003-03-15,1,0,0,Todas,0,44327
2003-03-17,19,0,0,Todas,0,44346
2003-03-18,14,0,0,Todas,0,44360
2003-03-19,11,0,0,Todas,0,44371
2003-03-20,7,0,0,Todas,0,44378
2003-03-21,9,0,0,Todas,0,44387
2003-03-24,11,0,0,Todas,0,44398
2003-03-25,13,0,0,Todas,0,44411
2003-03-26,10,0,0,Todas,0,44421
2003-03-27,13,0,0,Todas,0,44434
2003-03-28,10,0,0,Todas,0,44444
2003-03-31,20,0,0,Todas,0,44464
2003-04-01,13,0,0,Todas,0,44477
2003-04-02,12,0,0,Todas,0,44489
2003-04-03,12,0,0,Todas,0,44501
2003-04-04,12,0,0,Todas,0,44513
2003-04-07,7,0,0,Todas,0,44520
2003-04-08,6,0,0,Todas,0,44526
2003-04-09,11,0,0,Todas,0,44537
2003-04-10,8,0,0,Todas,0,44545
2003-04-11,10,0,0,Todas,0,44555
2003-04-14,15,0,0,Todas,0,44570
2003-04-15,15,0,0,Todas,0,44585
2003-04-16,11,0,0,Todas,0,44596
2003-04-17,5,0,0,Todas,0,44601
2003-04-21,12,0,0,Todas,0,44613
2003-04-22,9,0,0,Todas,0,44622
2003-04-23,18,0,0,Todas,0,44640
2003-04-24,8,0,0,Todas,0,44648
2003-04-25,19,0,0,Todas,0,44667
2003-04-28,12,0,0,Todas,0,44679
2003-04-29,14,0,0,Todas,0,44693
2003-04-30,16,0,0,Todas,0,44709
2003-05-02,19,0,0,Todas,0,44728
2003-05-05,16,0,0,Todas,0,44744
2003-05-06,10,0,0,Todas,0,44754
2003-05-07,16,0,0,Todas,0,44770
2003-05-08,14,0,0,Todas,0,44784
2003-05-09,10,0,0,Todas,0,44794
2003-05-12,18,0,0,Todas,0,44812
2003-05-13,20,0,0,Todas,0,44832
2003-05-14,17,0,0,Todas,0,44849
2003-05-15,17,0,0,Todas,0,44866
2003-05-16,11,0,0,Todas,0,44877
2003-05-19,13,0,0,Todas,0,44890
2003-05-20,13,0,0,Todas,0,44903
2003-05-21,20,0,0,Todas,0,44923
2003-05-22,17,0,0,Todas,0,44940
2003-05-23,13,0,0,Todas,0,44953
2003-05-26,9,0,0,Todas,0,44962
2003-05-27,14,0,0,Todas,0,44976
2003-05-28,17,0,0,Todas,0,44993
2003-05-29,9,0,0,Todas,0,45002
2003-05-30,17,0,0,Todas,0,45019
2003-06-01,1,0,0,Todas,0,45020
2003-06-02,8,0,0,Todas,0,45028
2003-06-03,16,0,0,Todas,0,45044
2003-06-04,20,0,0,Todas,0,45064
2003-06-05,13,0,0,Todas,0,45077
2003-06-06,11,0,0,Todas,0,45088
2003-06-09,15,0,0,Todas,0,45103
2003-06-10,13,0,0,Todas,0,45116
2003-06-11,17,0,0,Todas,0,45133
2003-06-12,7,0,0,Todas,0,45140
2003-06-13,10,0,0,Todas,0,45150
2003-06-15,1,0,0,Todas,0,45151
2003-06-16,11,0,0,Todas,0,45162
2003-06-17,17,0,0,Todas,0,45179
2003-06-18,13,0,0,Todas,0,45192
2003-06-19,12,0,0,Todas,0,45204
2003-06-20,17,0,0,Todas,0,45221
2003-06-23,18,0,0,Todas,0,45239
2003-06-24,12,0,0,Todas,0,45251
2003-06-25,10,0,0,Todas,0,45261
2003-06-26,11,0,0,Todas,0,45272
2003-06-27,6,0,0,Todas,0,45278
2003-06-30,7,0,0,Todas,0,45285
2003-07-01,19,0,0,Todas,0,45304
2003-07-02,11,0,0,Todas,0,45315
2003-07-03,18,0,0,Todas,0,45333
2003-07-04,12,0,0,Todas,0,45345
2003-07-06,1,0,0,Todas,0,45346
2003-07-07,9,0,0,Todas,0,45355
2003-07-08,14,0,0,Todas,0,45369
2003-07-09,17,0,0,Todas,0,45386
2003-07-10,18,0,0,Todas,0,45404
2003-07-11,16,0,0,Todas,0,45420
2003-07-14,10,0,0,Todas,0,45430
2003-07-15,12,0,0,Todas,0,45442
2003-07-16,19,0,0,Todas,0,45461
2003-07-17,9,0,0,Todas,0,45470
2003-07-18,6,0,0,Todas,0,45476
2003-07-20,1,0,0,Todas,0,45477
2003-07-21,12,0,0,Todas,0,45489
2003-07-22,18,0,0,Todas,0,45507
2003-07-23,11,0,0,Todas,0,45518
2003-07-24,14,0,0,Todas,0,45532
2003-07-25,11,0,0,Todas,0,45543
2003-07-28,12,0,0,Todas,0,45555
2003-07-29,17,0,0,Todas,0,45572
2003-07-30,16,0,0,Todas,0,45588
2003-07-31,21,0,0,Todas,0,45609
2003-08-01,8,0,0,Todas,0,45617
2003-08-04,9,0,0,Todas,0,45626
2003-08-05,13,0,0,Todas,0,45639
2003-08-06,11,0,0,Todas,0,45650
2003-08-07,8,0,0,Todas,0,45658
2003-08-08,18,0,0,Todas,0,45676
2003-08-11,10,0,0,Todas,0,45686
2003-08-12,13,0,0,Todas,0,45699
2003-08-13,11,0,0,Todas,0,45710
2003-08-14,10,0,0,Todas,0,45720
2003-08-15,12,0,0,Todas,0,45732
2003-08-18,22,0,0,Todas,0,45754
2003-08-19,11,0,0,Todas,0,45765
2003-08-20,6,0,0,Todas,0,45771
2003-08-21,8,0,0,Todas,0,45779
2003-08-22,10,0,0,Todas,0,45789
2003-08-24,1,0,0,Todas,0,45790
2003-08-25,14,0,0,Todas,0,45804
2003-08-26,17,0,0,Todas,0,45821
2003-08-27,12,0,0,Todas,0,45833
2003-08-28,10,0,0,Todas,0,45843
2003-08-29,12,0,0,Todas,0,45855
2003-09-01,9,0,0,Todas,0,45864
2003-09-02,10,0,0,Todas,0,45874
2003-09-03,14,0,0,Todas,0,45888
2003-09-04,10,0,0,Todas,0,45898
2003-09-05,9,0,0,Todas,0,45907
2003-09-08,9,0,0,Todas,0,45916
2003-09-09,5,0,0,Todas,0,45921
2003-09-10,14,0,0,Todas,0,45935
2003-09-11,9,0,0,Todas,0,45944
2003-09-12,7,0,0,Todas,0,45951
2003-09-13,1,0,0,Todas,0,45952
2003-09-15,11,0,0,Todas,0,45963
2003-09-16,11,0,0,Todas,0,45974
2003-09-17,7,0,0,Todas,0,45981
2003-09-18,8,0,0,Todas,0,45989
2003-09-19,8,0,0,Todas,0,45997
2003-09-20,1,0,0,Todas,0,45998
2003-09-22,7,0,0,Todas,0,46005
2003-09-23,9,0,0,Todas,0,46014
2003-09-24,8,0,0,Todas,0,46022
2003-09-25,11,0,0,Todas,0,46033
2003-09-26,4,0,0,Todas,0,46037
2003-09-29,6,0,0,Todas,0,46043
2003-09-30,11,0,0,Todas,0,46054
2003-10-01,11,0,0,Todas,0,46065
2003-10-02,7,0,0,Todas,0,46072
2003-10-03,7,0,0,Todas,0,46079
2003-10-06,10,0,0,Todas,0,46089
2003-10-07,7,0,0,Todas,0,46096
2003-10-08,11,0,0,Todas,0,46107
2003-10-09,10,0,0,Todas,0,46117
2003-10-12,1,0,0,Todas,0,46118
2003-10-13,13,0,0,Todas,0,46131
2003-10-14,17,0,0,Todas,0,46148
2003-10-15,15,0,0,Todas,0,46163
2003-10-16,17,0,0,Todas,0,46180
2003-10-17,9,0,0,Todas,0,46189
2003-10-20,8,0,0,Todas,0,46197
2003-10-21,10,0,0,Todas,0,46207
2003-10-22,14,0,0,Todas,0,46221
2003-10-23,12,0,0,Todas,0,46233
2003-10-24,2,0,0,Todas,0,46235
2003-10-27,12,0,0,Todas,0,46247
2003-10-28,15,0,0,Todas,0,46262
2003-10-29,10,0,0,Todas,0,46272
2003-10-30,8,0,0,Todas,0,46280
2003-10-31,9,0,0,Todas,0,46289
2003-11-04,17,0,0,Todas,0,46306
2003-11-05,8,0,0,Todas,0,46314
2003-11-06,9,0,0,Todas,0,46323
2003-11-07,11,0,0,Todas,0,46334
2003-11-10,12,0,0,Todas,0,46346
2003-11-11,12,0,0,Todas,0,46358
2003-11-12,14,0,0,Todas,0,46372
2003-11-13,14,0,0,Todas,0,46386
2003-11-14,6,0,0,Todas,0,46392
2003-11-16,1,0,0,Todas,0,46393
2003-11-17,13,0,0,Todas,0,46406
2003-11-18,13,0,0,Todas,0,46419
2003-11-19,18,0,0,Todas,0,46437
2003-11-20,13,0,0,Todas,0,46450
2003-11-21,10,0,0,Todas,0,46460
2003-11-24,10,0,0,Todas,0,46470
2003-11-25,11,0,0,Todas,0,46481
2003-11-26,16,0,0,Todas,0,46497
2003-11-27,12,0,0,Todas,0,46509
2003-11-28,13,0,0,Todas,0,46522
2003-12-01,6,0,0,Todas,0,46528
2003-12-02,15,0,0,Todas,0,46543
2003-12-03,10,0,0,Todas,0,46553
2003-12-04,4,0,0,Todas,0,46557
2003-12-05,2,0,0,Todas,0,46559
2003-12-08,14,0,0,Todas,0,46573
2003-12-09,8,0,0,Todas,0,46581
2003-12-10,16,0,0,Todas,0,46597
2003-12-11,17,0,0,Todas,0,46614
2003-12-12,9,0,0,Todas,0,46623
2003-12-15,4,0,0,Todas,0,46627
2003-12-16,17,0,0,Todas,0,46644
2003-12-17,12,0,0,Todas,0,46656
2003-12-18,10,0,0,Todas,0,46666
2003-12-19,10,0,0,Todas,0,46676
2003-12-22,6,0,0,Todas,0,46682
2003-12-23,14,0,0,Todas,0,46696
2003-12-24,2,0,0,Todas,0,46698
2003-12-29,9,0,0,Todas,0,46707
2003-12-30,7,0,0,Todas,0,46714
2003-12-31,6,0,0,Todas,0,46720
2004-01-01,1,0,0,Todas,0,46721
2004-01-02,1,0,0,Todas,0,46722
2004-01-05,9,0,0,Todas,0,46731
2004-01-06,8,0,0,Todas,0,46739
2004-01-07,8,0,0,Todas,0,46747
2004-01-08,20,0,0,Todas,0,46767
2004-01-09,9,0,0,Todas,0,46776
2004-01-12,11,0,0,Todas,0,46787
2004-01-13,5,0,0,Todas,0,46792
2004-01-14,8,0,0,Todas,0,46800
2004-01-15,13,0,0,Todas,0,46813
2004-01-16,8,0,0,Todas,0,46821
2004-01-19,13,0,0,Todas,0,46834
2004-01-20,13,0,0,Todas,0,46847
2004-01-21,13,0,0,Todas,0,46860
2004-01-22,14,0,0,Todas,0,46874
2004-01-23,11,0,0,Todas,0,46885
2004-01-26,15,0,0,Todas,0,46900
2004-01-27,11,0,0,Todas,0,46911
2004-01-28,10,0,0,Todas,0,46921
2004-01-29,8,0,0,Todas,0,46929
2004-01-30,15,0,0,Todas,0,46944
2004-02-01,1,0,0,Todas,0,46945
2004-02-02,13,0,0,Todas,0,46958
2004-02-03,13,0,0,Todas,0,46971
2004-02-04,8,0,0,Todas,0,46979
2004-02-05,8,0,0,Todas,0,46987
2004-02-06,5,0,0,Todas,0,46992
2004-02-08,1,0,0,Todas,0,46993
2004-02-09,8,0,0,Todas,0,47001
2004-02-10,10,0,0,Todas,0,47011
2004-02-11,10,0,0,Todas,0,47021
2004-02-12,15,0,0,Todas,0,47036
2004-02-13,9,0,0,Todas,0,47045
2004-02-16,7,0,0,Todas,0,47052
2004-02-17,17,0,0,Todas,0,47069
2004-02-18,11,0,0,Todas,0,47080
2004-02-19,25,0,0,Todas,0,47105
2004-02-20,12,0,0,Todas,0,47117
2004-02-25,16,0,0,Todas,0,47133
2004-02-26,13,0,0,Todas,0,47146
2004-02-27,10,0,0,Todas,0,47156
2004-03-01,11,0,0,Todas,0,47167
2004-03-02,7,0,0,Todas,0,47174
2004-03-03,14,0,0,Todas,0,47188
2004-03-04,19,0,0,Todas,0,47207
2004-03-05,12,0,0,Todas,0,47219
2004-03-08,9,0,0,Todas,0,47228
2004-03-09,5,0,0,Todas,0,47233
2004-03-10,10,0,0,Todas,0,47243
2004-03-11,9,0,0,Todas,0,47252
2004-03-12,7,0,0,Todas,0,47259
2004-03-15,10,0,0,Todas,0,47269
2004-03-16,18,0,0,Todas,0,47287
2004-03-17,11,0,0,Todas,0,47298
2004-03-18,17,0,0,Todas,0,47315
2004-03-19,13,0,0,Todas,0,47328
2004-03-22,15,0,0,Todas,0,47343
2004-03-23,19,0,0,Todas,0,47362
2004-03-24,11,0,0,Todas,0,47373
2004-03-25,13,0,0,Todas,0,47386
2004-03-26,14,0,0,Todas,0,47400
2004-03-29,11,0,0,Todas,0,47411
2004-03-30,16,0,0,Todas,0,47427
2004-03-31,18,0,0,Todas,0,47445
2004-04-01,13,0,0,Todas,0,47458
2004-04-02,11,0,0,Todas,0,47469
2004-04-05,15,0,0,Todas,0,47484
2004-04-06,12,0,0,Todas,0,47496
2004-04-07,16,0,0,Todas,0,47512
2004-04-08,5,0,0,Todas,0,47517
2004-04-10,1,0,0,Todas,0,47518
2004-04-11,1,0,0,Todas,0,47519
2004-04-12,13,0,0,Todas,0,47532
2004-04-13,19,0,0,Todas,0,47551
2004-04-14,10,0,0,Todas,0,47561
2004-04-15,21,0,0,Todas,0,47582
2004-04-16,12,0,0,Todas,0,47594
2004-04-19,9,0,0,Todas,0,47603
2004-04-20,8,0,0,Todas,0,47611
2004-04-21,12,0,0,Todas,0,47623
2004-04-22,15,0,0,Todas,0,47638
2004-04-23,13,0,0,Todas,0,47651
2004-04-24,1,0,0,Todas,0,47652
2004-04-25,2,0,0,Todas,0,47654
2004-04-26,10,0,0,Todas,0,47664
2004-04-27,9,0,0,Todas,0,47673
2004-04-28,9,0,0,Todas,0,47682
2004-04-29,12,0,0,Todas,0,47694
2004-04-30,11,0,0,Todas,0,47705
2004-05-01,1,0,0,Todas,0,47706
2004-05-03,16,0,0,Todas,0,47722
2004-05-04,16,0,0,Todas,0,47738
2004-05-05,9,0,0,Todas,0,47747
2004-05-06,6,0,0,Todas,0,47753
2004-05-07,8,0,0,Todas,0,47761
2004-05-10,14,0,0,Todas,0,47775
2004-05-11,18,0,0,Todas,0,47793
2004-05-12,11,0,0,Todas,0,47804
2004-05-13,13,0,0,Todas,0,47817
2004-05-14,14,0,0,Todas,0,47831
2004-05-17,6,0,0,Todas,0,47837
2004-05-18,13,0,0,Todas,0,47850
2004-05-19,18,0,0,Todas,0,47868
2004-05-20,20,0,0,Todas,0,47888
2004-05-21,17,0,0,Todas,0,47905
2004-05-25,10,0,0,Todas,0,47915
2004-05-26,20,0,0,Todas,0,47935
2004-05-27,10,0,0,Todas,0,47945
2004-05-28,7,0,0,Todas,0,47952
2004-05-29,1,0,0,Todas,0,47953
2004-05-31,16,0,0,Todas,0,47969
2004-06-01,9,0,0,Todas,0,47978
2004-06-02,8,0,0,Todas,0,47986
2004-06-03,19,0,0,Todas,0,48005
2004-06-04,8,0,0,Todas,0,48013
2004-06-07,12,0,0,Todas,0,48025
2004-06-08,19,0,0,Todas,0,48044
2004-06-09,17,0,0,Todas,0,48061
2004-06-10,19,0,0,Todas,0,48080
2004-06-11,13,0,0,Todas,0,48093
2004-06-12,1,0,0,Todas,0,48094
2004-06-14,9,0,0,Todas,0,48103
2004-06-15,15,0,0,Todas,0,48118
2004-06-16,9,0,0,Todas,0,48127
2004-06-17,15,0,0,Todas,0,48142
2004-06-18,6,0,0,Todas,0,48148
2004-06-21,17,0,0,Todas,0,48165
2004-06-22,14,0,0,Todas,0,48179
2004-06-23,18,0,0,Todas,0,48197
2004-06-24,8,0,0,Todas,0,48205
2004-06-25,7,0,0,Todas,0,48212
2004-06-28,12,0,0,Todas,0,48224
2004-06-29,14,0,0,Todas,0,48238
2004-06-30,10,0,0,Todas,0,48248
2004-07-01,17,0,0,Todas,0,48265
2004-07-02,12,0,0,Todas,0,48277
2004-07-05,15,0,0,Todas,0,48292
2004-07-06,18,0,0,Todas,0,48310
2004-07-07,10,0,0,Todas,0,48320
2004-07-08,8,0,0,Todas,0,48328
2004-07-09,13,0,0,Todas,0,48341
2004-07-12,15,0,0,Todas,0,48356
2004-07-13,8,0,0,Todas,0,48364
2004-07-14,7,0,0,Todas,0,48371
2004-07-15,13,0,0,Todas,0,48384
2004-07-16,7,0,0,Todas,0,48391
2004-07-17,1,0,0,Todas,0,48392
2004-07-19,13,0,0,Todas,0,48405
2004-07-20,8,0,0,Todas,0,48413
2004-07-21,12,0,0,Todas,0,48425
2004-07-22,12,0,0,Todas,0,48437
2004-07-23,13,0,0,Todas,0,48450
2004-07-26,12,0,0,Todas,0,48462
2004-07-27,5,0,0,Todas,0,48467
2004-07-28,12,0,0,Todas,0,48479
2004-07-29,20,0,0,Todas,0,48499
2004-07-30,16,0,0,Todas,0,48515
2004-08-02,14,0,0,Todas,0,48529
2004-08-03,18,0,0,Todas,0,48547
2004-08-04,16,0,0,Todas,0,48563
2004-08-05,12,0,0,Todas,0,48575
2004-08-06,15,0,0,Todas,0,48590
2004-08-09,10,0,0,Todas,0,48600
2004-08-10,3,0,0,Todas,0,48603
2004-08-11,8,0,0,Todas,0,48611
2004-08-12,10,0,0,Todas,0,48621
2004-08-16,14,0,0,Todas,0,48635
2004-08-17,7,0,0,Todas,0,48642
2004-08-18,18,0,0,Todas,0,48660
2004-08-19,4,0,0,Todas,0,48664
2004-08-20,8,0,0,Todas,0,48672
2004-08-23,14,0,0,Todas,0,48686
2004-08-24,13,0,0,Todas,0,48699
2004-08-25,14,0,0,Todas,0,48713
2004-08-26,16,0,0,Todas,0,48729
2004-08-27,11,0,0,Todas,0,48740
2004-08-30,14,0,0,Todas,0,48754
2004-08-31,10,0,0,Todas,0,48764
2004-09-01,14,0,0,Todas,0,48778
2004-09-02,11,0,0,Todas,0,48789
2004-09-03,9,0,0,Todas,0,48798
2004-09-06,9,0,0,Todas,0,48807
2004-09-07,8,0,0,Todas,0,48815
2004-09-08,10,0,0,Todas,0,48825
2004-09-09,6,0,0,Todas,0,48831
2004-09-10,7,0,0,Todas,0,48838
2004-09-13,11,0,0,Todas,0,48849
2004-09-14,15,0,0,Todas,0,48864
2004-09-15,8,0,0,Todas,0,48872
2004-09-16,10,0,0,Todas,0,48882
2004-09-17,32,0,0,Todas,0,48914
2004-09-20,4,0,0,Todas,0,48918
2004-09-21,7,0,0,Todas,0,48925
2004-09-22,21,0,0,Todas,0,48946
2004-09-23,16,0,0,Todas,0,48962
2004-09-24,12,0,0,Todas,0,48974
2004-09-27,12,0,0,Todas,0,48986
2004-09-28,8,0,0,Todas,0,48994
2004-09-29,18,0,0,Todas,0,49012
2004-09-30,15,0,0,Todas,0,49027
2004-10-01,9,0,0,Todas,0,49036
2004-10-04,9,0,0,Todas,0,49045
2004-10-05,8,0,0,Todas,0,49053
2004-10-06,17,0,0,Todas,0,49070
2004-10-07,9,0,0,Todas,0,49079
2004-10-08,20,0,0,Todas,0,49099
2004-10-11,15,0,0,Todas,0,49114
2004-10-12,19,0,0,Todas,0,49133
2004-10-13,8,0,0,Todas,0,49141
2004-10-14,10,0,0,Todas,0,49151
2004-10-15,11,0,0,Todas,0,49162
2004-10-18,9,0,0,Todas,0,49171
2004-10-19,9,0,0,Todas,0,49180
2004-10-20,18,0,0,Todas,0,49198
2004-10-21,13,0,0,Todas,0,49211
2004-10-22,6,0,0,Todas,0,49217
2004-10-25,6,0,0,Todas,0,49223
2004-10-26,6,0,0,Todas,0,49229
2004-10-27,10,0,0,Todas,0,49239
2004-10-28,15,0,0,Todas,0,49254
2004-10-29,9,0,0,Todas,0,49263
2004-10-31,1,0,0,Todas,0,49264
2004-11-04,18,0,0,Todas,0,49282
2004-11-05,14,0,0,Todas,0,49296
2004-11-08,13,0,0,Todas,0,49309
2004-11-09,15,0,0,Todas,0,49324
2004-11-10,11,0,0,Todas,0,49335
2004-11-11,17,0,0,Todas,0,49352
2004-11-12,9,0,0,Todas,0,49361
2004-11-15,16,0,0,Todas,0,49377
2004-11-16,13,0,0,Todas,0,49390
2004-11-17,12,0,0,Todas,0,49402
2004-11-18,20,0,0,Todas,0,49422
2004-11-19,12,0,0,Todas,0,49434
2004-11-22,9,0,0,Todas,0,49443
2004-11-23,12,0,0,Todas,0,49455
2004-11-24,11,0,0,Todas,0,49466
2004-11-25,22,0,0,Todas,0,49488
2004-11-26,12,0,0,Todas,0,49500
2004-11-29,18,0,0,Todas,0,49518
2004-11-30,12,0,0,Todas,0,49530
2004-12-01,15,0,0,Todas,0,49545
2004-12-02,21,0,0,Todas,0,49566
2004-12-03,8,0,0,Todas,0,49574
2004-12-04,1,0,0,Todas,0,49575
2004-12-07,17,0,0,Todas,0,49592
2004-12-08,4,0,0,Todas,0,49596
2004-12-09,3,0,0,Todas,0,49599
2004-12-10,7,0,0,Todas,0,49606
2004-12-13,15,0,0,Todas,0,49621
2004-12-14,11,0,0,Todas,0,49632
2004-12-15,12,0,0,Todas,0,49644
2004-12-16,11,0,0,Todas,0,49655
2004-12-17,19,0,0,Todas,0,49674
2004-12-20,9,0,0,Todas,0,49683
2004-12-21,8,0,0,Todas,0,49691
2004-12-22,8,0,0,Todas,0,49699
2004-12-23,13,0,0,Todas,0,49712
2004-12-24,4,0,0,Todas,0,49716
2004-12-27,6,0,0,Todas,0,49722
2004-12-28,12,0,0,Todas,0,49734
2004-12-29,4,0,0,Todas,0,49738
2004-12-30,11,0,0,Todas,0,49749
2004-12-31,9,0,0,Todas,0,49758
2005-01-01,2,0,0,Todas,0,49760
2005-01-03,11,0,0,Todas,0,49771
2005-01-04,12,0,0,Todas,0,49783
2005-01-05,12,0,0,Todas,0,49795
2005-01-06,11,0,0,Todas,0,49806
2005-01-07,12,0,0,Todas,0,49818
2005-01-08,2,0,0,Todas,0,49820
2005-01-10,23,0,0,Todas,0,49843
2005-01-11,8,0,0,Todas,0,49851
2005-01-12,15,0,0,Todas,0,49866
2005-01-13,11,0,0,Todas,0,49877
2005-01-14,11,0,0,Todas,0,49888
2005-01-17,11,0,0,Todas,0,49899
2005-01-18,14,0,0,Todas,0,49913
2005-01-19,13,0,0,Todas,0,49926
2005-01-20,14,0,0,Todas,0,49940
2005-01-21,14,0,0,Todas,0,49954
2005-01-24,9,0,0,Todas,0,49963
2005-01-25,6,0,0,Todas,0,49969
2005-01-26,11,0,0,Todas,0,49980
2005-01-27,13,0,0,Todas,0,49993
2005-01-28,14,0,0,Todas,0,50007
2005-01-29,1,0,0,Todas,0,50008
2005-01-30,1,0,0,Todas,0,50009
2005-01-31,19,0,0,Todas,0,50028
2005-02-01,20,0,0,Todas,0,50048
2005-02-02,11,0,0,Todas,0,50059
2005-02-03,13,0,0,Todas,0,50072
2005-02-04,16,0,0,Todas,0,50088
2005-02-09,15,0,0,Todas,0,50103
2005-02-10,12,0,0,Todas,0,50115
2005-02-11,13,0,0,Todas,0,50128
2005-02-14,11,0,0,Todas,0,50139
2005-02-15,10,0,0,Todas,0,50149
2005-02-16,13,0,0,Todas,0,50162
2005-02-17,14,0,0,Todas,0,50176
2005-02-18,10,0,0,Todas,0,50186
2005-02-19,1,0,0,Todas,0,50187
2005-02-21,7,0,0,Todas,0,50194
2005-02-22,7,0,0,Todas,0,50201
2005-02-23,6,0,0,Todas,0,50207
2005-02-24,10,0,0,Todas,0,50217
2005-02-25,14,0,0,Todas,0,50231
2005-02-26,1,0,0,Todas,0,50232
2005-02-28,10,0,0,Todas,0,50242
2005-03-01,18,0,0,Todas,0,50260
2005-03-02,3,0,0,Todas,0,50263
2005-03-03,3,0,0,Todas,0,50266
2005-03-04,14,0,0,Todas,0,50280
2005-03-07,14,0,0,Todas,0,50294
2005-03-08,18,0,0,Todas,0,50312
2005-03-09,9,0,0,Todas,0,50321
2005-03-10,18,0,0,Todas,0,50339
2005-03-11,14,0,0,Todas,0,50353
2005-03-13,1,0,0,Todas,0,50354
2005-03-14,8,0,0,Todas,0,50362
2005-03-15,5,0,0,Todas,0,50367
2005-03-16,3,0,0,Todas,0,50370
2005-03-17,1,0,0,Todas,0,50371
2005-03-18,5,0,0,Todas,0,50376
2005-03-21,1,0,0,Todas,0,50377
2005-03-22,5,0,0,Todas,0,50382
2005-03-23,8,0,0,Todas,0,50390
2005-03-28,12,0,0,Todas,0,50402
2005-03-29,20,0,0,Todas,0,50422
2005-03-30,16,0,0,Todas,0,50438
2005-03-31,14,0,0,Todas,0,50452
2005-04-01,23,0,0,Todas,0,50475
2005-04-04,5,0,0,Todas,0,50480
2005-04-05,1,0,0,Todas,0,50481
2005-04-06,2,0,0,Todas,0,50483
2005-04-07,13,0,0,Todas,0,50496
2005-04-08,13,0,0,Todas,0,50509
2005-04-10,1,0,0,Todas,0,50510
2005-04-11,18,0,0,Todas,0,50528
2005-04-12,19,0,0,Todas,0,50547
2005-04-13,3,0,0,Todas,0,50550
2005-04-14,20,0,0,Todas,0,50570
2005-04-15,13,0,0,Todas,0,50583
2005-04-18,14,0,0,Todas,0,50597
2005-04-19,10,0,0,Todas,0,50607
2005-04-20,16,0,0,Todas,0,50623
2005-04-21,6,0,0,Todas,0,50629
2005-04-22,10,0,0,Todas,0,50639
2005-04-25,14,0,0,Todas,0,50653
2005-04-26,9,0,0,Todas,0,50662
2005-04-27,17,0,0,Todas,0,50679
2005-04-28,16,0,0,Todas,0,50695
2005-04-29,18,0,0,Todas,0,50713
2005-05-01,1,0,0,Todas,0,50714
2005-05-02,10,0,0,Todas,0,50724
2005-05-03,9,0,0,Todas,0,50733
2005-05-04,7,0,0,Todas,0,50740
2005-05-05,7,0,0,Todas,0,50747
2005-05-06,12,0,0,Todas,0,50759
2005-05-09,12,0,0,Todas,0,50771
2005-05-10,10,0,0,Todas,0,50781
2005-05-11,10,0,0,Todas,0,50791
2005-05-12,11,0,0,Todas,0,50802
2005-05-13,10,0,0,Todas,0,50812
2005-05-15,1,0,0,Todas,0,50813
2005-05-16,17,0,0,Todas,0,50830
2005-05-17,12,0,0,Todas,0,50842
2005-05-18,8,0,0,Todas,0,50850
2005-05-19,8,0,0,Todas,0,50858
2005-05-20,13,0,0,Todas,0,50871
2005-05-21,1,0,0,Todas,0,50872
2005-05-23,8,0,0,Todas,0,50880
2005-05-24,13,0,0,Todas,0,50893
2005-05-25,13,0,0,Todas,0,50906
2005-05-26,11,0,0,Todas,0,50917
2005-05-30,16,0,0,Todas,0,50933
2005-05-31,14,0,0,Todas,0,50947
2005-06-01,13,0,0,Todas,0,50960
2005-06-02,14,0,0,Todas,0,50974
2005-06-03,10,0,0,Todas,0,50984
2005-06-06,17,0,0,Todas,0,51001
2005-06-07,3,0,0,Todas,0,51004
2005-06-08,5,0,0,Todas,0,51009
2005-06-09,12,0,0,Todas,0,51021
2005-06-10,9,0,0,Todas,0,51030
2005-06-11,1,0,0,Todas,0,51031
2005-06-13,18,0,0,Todas,0,51049
2005-06-14,9,0,0,Todas,0,51058
2005-06-15,14,0,0,Todas,0,51072
2005-06-16,16,0,0,Todas,0,51088
2005-06-17,10,0,0,Todas,0,51098
2005-06-20,9,0,0,Todas,0,51107
2005-06-21,13,0,0,Todas,0,51120
2005-06-22,9,0,0,Todas,0,51129
2005-06-23,9,0,0,Todas,0,51138
2005-06-24,12,0,0,Todas,0,51150
2005-06-25,1,0,0,Todas,0,51151
2005-06-27,12,0,0,Todas,0,51163
2005-06-28,7,0,0,Todas,0,51170
2005-06-29,4,0,0,Todas,0,51174
2005-06-30,7,0,0,Todas,0,51181
2005-07-01,12,0,0,Todas,0,51193
2005-07-04,13,0,0,Todas,0,51206
2005-07-05,24,0,0,Todas,0,51230
2005-07-06,15,0,0,Todas,0,51245
2005-07-07,11,0,0,Todas,0,51256
2005-07-08,10,0,0,Todas,0,51266
2005-07-11,6,0,0,Todas,0,51272
2005-07-12,16,0,0,Todas,0,51288
2005-07-13,9,0,0,Todas,0,51297
2005-07-14,11,0,0,Todas,0,51308
2005-07-15,4,0,0,Todas,0,51312
2005-07-18,12,0,0,Todas,0,51324
2005-07-19,12,0,0,Todas,0,51336
2005-07-20,15,0,0,Todas,0,51351
2005-07-21,11,0,0,Todas,0,51362
2005-07-22,12,0,0,Todas,0,51374
2005-07-25,9,0,0,Todas,0,51383
2005-07-26,12,0,0,Todas,0,51395
2005-07-27,14,0,0,Todas,0,51409
2005-07-28,16,0,0,Todas,0,51425
2005-07-29,12,0,0,Todas,0,51437
2005-08-01,16,0,0,Todas,0,51453
2005-08-02,15,0,0,Todas,0,51468
2005-08-03,12,0,0,Todas,0,51480
2005-08-04,10,0,0,Todas,0,51490
2005-08-05,14,0,0,Todas,0,51504
2005-08-06,1,0,0,Todas,0,51505
2005-08-08,12,0,0,Todas,0,51517
2005-08-09,13,0,0,Todas,0,51530
2005-08-10,10,0,0,Todas,0,51540
2005-08-11,11,0,0,Todas,0,51551
2005-08-14,1,0,0,Todas,0,51552
2005-08-15,14,0,0,Todas,0,51566
2005-08-16,9,0,0,Todas,0,51575
2005-08-17,17,0,0,Todas,0,51592
2005-08-18,10,0,0,Todas,0,51602
2005-08-19,14,0,0,Todas,0,51616
2005-08-22,15,0,0,Todas,0,51631
2005-08-23,13,0,0,Todas,0,51644
2005-08-24,15,0,0,Todas,0,51659
2005-08-25,19,0,0,Todas,0,51678
2005-08-26,8,0,0,Todas,0,51686
2005-08-28,1,0,0,Todas,0,51687
2005-08-29,18,0,0,Todas,0,51705
2005-08-30,18,0,0,Todas,0,51723
2005-08-31,13,0,0,Todas,0,51736
2005-09-01,12,0,0,Todas,0,51748
2005-09-02,8,0,0,Todas,0,51756
2005-09-05,7,0,0,Todas,0,51763
2005-09-06,10,0,0,Todas,0,51773
2005-09-07,16,0,0,Todas,0,51789
2005-09-08,7,0,0,Todas,0,51796
2005-09-09,11,0,0,Todas,0,51807
2005-09-12,9,0,0,Todas,0,51816
2005-09-13,3,0,0,Todas,0,51819
2005-09-14,10,0,0,Todas,0,51829
2005-09-15,13,0,0,Todas,0,51842
2005-09-16,11,0,0,Todas,0,51853
2005-09-19,13,0,0,Todas,0,51866
2005-09-20,12,0,0,Todas,0,51878
2005-09-21,16,0,0,Todas,0,51894
2005-09-22,10,0,0,Todas,0,51904
2005-09-23,10,0,0,Todas,0,51914
2005-09-26,18,0,0,Todas,0,51932
2005-09-27,9,0,0,Todas,0,51941
2005-09-28,16,0,0,Todas,0,51957
2005-09-29,15,0,0,Todas,0,51972
2005-09-30,9,0,0,Todas,0,51981
2005-10-03,6,0,0,Todas,0,51987
2005-10-04,10,0,0,Todas,0,51997
2005-10-05,9,0,0,Todas,0,52006
2005-10-06,10,0,0,Todas,0,52016
2005-10-07,17,0,0,Todas,0,52033
2005-10-08,1,0,0,Todas,0,52034
2005-10-10,15,0,0,Todas,0,52049
2005-10-11,10,0,0,Todas,0,52059
2005-10-12,13,0,0,Todas,0,52072
2005-10-13,8,0,0,Todas,0,52080
2005-10-14,14,0,0,Todas,0,52094
2005-10-17,11,0,0,Todas,0,52105
2005-10-18,13,0,0,Todas,0,52118
2005-10-19,11,0,0,Todas,0,52129
2005-10-20,8,0,0,Todas,0,52137
2005-10-21,10,0,0,Todas,0,52147
2005-10-23,1,0,0,Todas,0,52148
2005-10-24,6,0,0,Todas,0,52154
2005-10-25,16,0,0,Todas,0,52170
2005-10-26,9,0,0,Todas,0,52179
2005-10-27,9,0,0,Todas,0,52188
2005-10-28,12,0,0,Todas,0,52200
2005-10-31,14,0,0,Todas,0,52214
2005-11-01,22,0,0,Todas,0,52236
2005-11-02,1,0,0,Todas,0,52237
2005-11-04,10,0,0,Todas,0,52247
2005-11-07,11,0,0,Todas,0,52258
2005-11-08,11,0,0,Todas,0,52269
2005-11-09,14,0,0,Todas,0,52283
2005-11-10,15,0,0,Todas,0,52298
2005-11-11,10,0,0,Todas,0,52308
2005-11-14,17,0,0,Todas,0,52325
2005-11-15,6,0,0,Todas,0,52331
2005-11-16,9,0,0,Todas,0,52340
2005-11-17,16,0,0,Todas,0,52356
2005-11-18,8,0,0,Todas,0,52364
2005-11-20,1,0,0,Todas,0,52365
2005-11-21,11,0,0,Todas,0,52376
2005-11-22,8,0,0,Todas,0,52384
2005-11-23,10,0,0,Todas,0,52394
2005-11-24,14,0,0,Todas,0,52408
2005-11-25,11,0,0,Todas,0,52419
2005-11-28,10,0,0,Todas,0,52429
2005-11-29,13,0,0,Todas,0,52442
2005-11-30,9,0,0,Todas,0,52451
2005-12-01,12,0,0,Todas,0,52463
2005-12-02,9,0,0,Todas,0,52472
2005-12-05,8,0,0,Todas,0,52480
2005-12-06,1,0,0,Todas,0,52481
2005-12-07,16,0,0,Todas,0,52497
2005-12-08,17,0,0,Todas,0,52514
2005-12-09,15,0,0,Todas,0,52529
2005-12-11,1,0,0,Todas,0,52530
2005-12-12,15,0,0,Todas,0,52545
2005-12-13,15,0,0,Todas,0,52560
2005-12-14,8,0,0,Todas,0,52568
2005-12-15,11,0,0,Todas,0,52579
2005-12-16,11,0,0,Todas,0,52590
2005-12-19,9,0,0,Todas,0,52599
2005-12-20,20,0,0,Todas,0,52619
2005-12-21,10,0,0,Todas,0,52629
2005-12-22,22,0,0,Todas,0,52651
2005-12-23,10,0,0,Todas,0,52661
2005-12-26,11,0,0,Todas,0,52672
2005-12-27,12,0,0,Todas,0,52684
2005-12-28,12,0,0,Todas,0,52696
2005-12-29,17,0,0,Todas,0,52713
2005-12-30,2,0,0,Todas,0,52715
2006-01-01,3,0,0,Todas,0,52718
2006-01-02,14,0,0,Todas,0,52732
2006-01-03,10,0,0,Todas,0,52742
2006-01-04,9,0,0,Todas,0,52751
2006-01-05,9,0,0,Todas,0,52760
2006-01-06,9,0,0,Todas,0,52769
2006-01-09,16,0,0,Todas,0,52785
2006-01-10,18,0,0,Todas,0,52803
2006-01-11,11,0,0,Todas,0,52814
2006-01-12,11,0,0,Todas,0,52825
2006-01-13,13,0,0,Todas,0,52838
2006-01-16,17,0,0,Todas,0,52855
2006-01-17,9,0,0,Todas,0,52864
2006-01-18,6,0,0,Todas,0,52870
2006-01-19,10,0,0,Todas,0,52880
2006-01-20,14,0,0,Todas,0,52894
2006-01-23,15,0,0,Todas,0,52909
2006-01-24,12,0,0,Todas,0,52921
2006-01-25,13,0,0,Todas,0,52934
2006-01-26,18,0,0,Todas,0,52952
2006-01-27,4,0,0,Todas,0,52956
2006-01-30,16,0,0,Todas,0,52972
2006-01-31,10,0,0,Todas,0,52982
2006-02-01,16,0,0,Todas,0,52998
2006-02-02,9,0,0,Todas,0,53007
2006-02-03,7,0,0,Todas,0,53014
2006-02-06,14,0,0,Todas,0,53028
2006-02-07,11,0,0,Todas,0,53039
2006-02-08,22,0,0,Todas,0,53061
2006-02-09,9,0,0,Todas,0,53070
2006-02-10,17,0,0,Todas,0,53087
2006-02-13,11,0,0,Todas,0,53098
2006-02-14,14,0,0,Todas,0,53112
2006-02-15,10,0,0,Todas,0,53122
2006-02-16,13,0,0,Todas,0,53135
2006-02-17,12,0,0,Todas,0,53147
2006-02-20,8,0,0,Todas,0,53155
2006-02-21,12,0,0,Todas,0,53167
2006-02-22,18,0,0,Todas,0,53185
2006-02-23,19,0,0,Todas,0,53204
2006-02-24,15,0,0,Todas,0,53219
2006-02-26,1,0,0,Todas,0,53220
2006-02-28,1,0,0,Todas,0,53221
2006-03-01,9,0,0,Todas,0,53230
2006-03-02,15,0,0,Todas,0,53245
2006-03-03,20,0,0,Todas,0,53265
2006-03-04,1,0,0,Todas,0,53266
2006-03-06,12,0,0,Todas,0,53278
2006-03-07,14,0,0,Todas,0,53292
2006-03-08,14,0,0,Todas,0,53306
2006-03-09,20,0,0,Todas,0,53326
2006-03-10,9,0,0,Todas,0,53335
2006-03-12,1,0,0,Todas,0,53336
2006-03-13,16,0,0,Todas,0,53352
2006-03-14,19,0,0,Todas,0,53371
2006-03-15,16,0,0,Todas,0,53387
2006-03-16,17,0,0,Todas,0,53404
2006-03-17,15,0,0,Todas,0,53419
2006-03-18,1,0,0,Todas,0,53420
2006-03-20,14,0,0,Todas,0,53434
2006-03-21,13,0,0,Todas,0,53447
2006-03-22,9,0,0,Todas,0,53456
2006-03-23,10,0,0,Todas,0,53466
2006-03-24,17,0,0,Todas,0,53483
2006-03-25,1,0,0,Todas,0,53484
2006-03-26,1,0,0,Todas,0,53485
2006-03-27,11,0,0,Todas,0,53496
2006-03-28,9,0,0,Todas,0,53505
2006-03-29,26,0,0,Todas,0,53531
2006-03-30,7,0,0,Todas,0,53538
2006-03-31,18,0,0,Todas,0,53556
2006-04-01,1,0,0,Todas,0,53557
2006-04-03,19,0,0,Todas,0,53576
2006-04-04,18,0,0,Todas,0,53594
2006-04-05,13,0,0,Todas,0,53607
2006-04-06,8,0,0,Todas,0,53615
2006-04-07,16,0,0,Todas,0,53631
2006-04-09,1,0,0,Todas,0,53632
2006-04-10,10,0,0,Todas,0,53642
2006-04-11,10,0,0,Todas,0,53652
2006-04-12,12,0,0,Todas,0,53664
2006-04-13,6,0,0,Todas,0,53670
2006-04-17,12,0,0,Todas,0,53682
2006-04-18,21,0,0,Todas,0,53703
2006-04-19,20,0,0,Todas,0,53723
2006-04-20,14,0,0,Todas,0,53737
2006-04-21,22,0,0,Todas,0,53759
2006-04-24,10,0,0,Todas,0,53769
2006-04-25,15,0,0,Todas,0,53784
2006-04-26,10,0,0,Todas,0,53794
2006-04-27,13,0,0,Todas,0,53807
2006-04-28,17,0,0,Todas,0,53824
2006-05-02,14,0,0,Todas,0,53838
2006-05-03,15,0,0,Todas,0,53853
2006-05-04,18,0,0,Todas,0,53871
2006-05-05,10,0,0,Todas,0,53881
2006-05-08,15,0,0,Todas,0,53896
2006-05-09,16,0,0,Todas,0,53912
2006-05-10,16,0,0,Todas,0,53928
2006-05-11,14,0,0,Todas,0,53942
2006-05-12,9,0,0,Todas,0,53951
2006-05-15,12,0,0,Todas,0,53963
2006-05-16,15,0,0,Todas,0,53978
2006-05-17,22,0,0,Todas,0,54000
2006-05-18,20,0,0,Todas,0,54020
2006-05-19,12,0,0,Todas,0,54032
2006-05-22,14,0,0,Todas,0,54046
2006-05-23,10,0,0,Todas,0,54056
2006-05-24,11,0,0,Todas,0,54067
2006-05-25,14,0,0,Todas,0,54081
2006-05-26,2,0,0,Todas,0,54083
2006-05-28,1,0,0,Todas,0,54084
2006-05-29,15,0,0,Todas,0,54099
2006-05-30,7,0,0,Todas,0,54106
2006-05-31,14,0,0,Todas,0,54120
2006-06-01,18,0,0,Todas,0,54138
2006-06-02,14,0,0,Todas,0,54152
2006-06-05,8,0,0,Todas,0,54160
2006-06-06,14,0,0,Todas,0,54174
2006-06-07,22,0,0,Todas,0,54196
2006-06-08,16,0,0,Todas,0,54212
2006-06-09,10,0,0,Todas,0,54222
2006-06-11,1,0,0,Todas,0,54223
2006-06-12,15,0,0,Todas,0,54238
2006-06-13,14,0,0,Todas,0,54252
2006-06-14,15,0,0,Todas,0,54267
2006-06-15,10,0,0,Todas,0,54277
2006-06-16,17,0,0,Todas,0,54294
2006-06-19,13,0,0,Todas,0,54307
2006-06-20,12,0,0,Todas,0,54319
2006-06-21,15,0,0,Todas,0,54334
2006-06-22,12,0,0,Todas,0,54346
2006-06-23,10,0,0,Todas,0,54356
2006-06-26,15,0,0,Todas,0,54371
2006-06-27,9,0,0,Todas,0,54380
2006-06-28,13,0,0,Todas,0,54393
2006-06-29,18,0,0,Todas,0,54411
2006-06-30,14,0,0,Todas,0,54425
2006-07-01,6,0,0,Todas,0,54431
2006-07-03,9,0,0,Todas,0,54440
2006-07-04,8,0,0,Todas,0,54448
2006-07-05,13,0,0,Todas,0,54461
2006-07-06,16,0,0,Todas,0,54477
2006-07-07,17,0,0,Todas,0,54494
2006-07-10,17,0,0,Todas,0,54511
2006-07-11,17,0,0,Todas,0,54528
2006-07-12,20,0,0,Todas,0,54548
2006-07-13,15,0,0,Todas,0,54563
2006-07-14,13,0,0,Todas,0,54576
2006-07-17,17,0,0,Todas,0,54593
2006-07-18,11,0,0,Todas,0,54604
2006-07-19,18,0,0,Todas,0,54622
2006-07-20,15,0,0,Todas,0,54637
2006-07-21,7,0,0,Todas,0,54644
2006-07-24,16,0,0,Todas,0,54660
2006-07-25,17,0,0,Todas,0,54677
2006-07-26,9,0,0,Todas,0,54686
2006-07-27,11,0,0,Todas,0,54697
2006-07-28,18,0,0,Todas,0,54715
2006-07-31,16,0,0,Todas,0,54731
2006-08-01,50,0,0,Todas,0,54781
2006-08-02,11,0,0,Todas,0,54792
2006-08-03,15,0,0,Todas,0,54807
2006-08-04,10,0,0,Todas,0,54817
2006-08-07,9,0,0,Todas,0,54826
2006-08-08,10,0,0,Todas,0,54836
2006-08-09,10,0,0,Todas,0,54846
2006-08-10,15,0,0,Todas,0,54861
2006-08-14,20,0,0,Todas,0,54881
2006-08-15,10,0,0,Todas,0,54891
2006-08-16,16,0,0,Todas,0,54907
2006-08-17,19,0,0,Todas,0,54926
2006-08-18,8,0,0,Todas,0,54934
2006-08-21,15,0,0,Todas,0,54949
2006-08-22,16,0,0,Todas,0,54965
2006-08-23,14,0,0,Todas,0,54979
2006-08-24,14,0,0,Todas,0,54993
2006-08-25,22,0,0,Todas,0,55015
2006-08-26,1,0,0,Todas,0,55016
2006-08-28,8,0,0,Todas,0,55024
2006-08-29,19,0,0,Todas,0,55043
2006-08-30,9,0,0,Todas,0,55052
2006-08-31,19,0,0,Todas,0,55071
2006-09-01,22,0,0,Todas,0,55093
2006-09-04,15,0,0,Todas,0,55108
2006-09-05,10,0,0,Todas,0,55118
2006-09-06,16,0,0,Todas,0,55134
2006-09-07,11,0,0,Todas,0,55145
2006-09-08,10,0,0,Todas,0,55155
2006-09-11,13,0,0,Todas,0,55168
2006-09-12,7,0,0,Todas,0,55175
2006-09-13,15,0,0,Todas,0,55190
2006-09-14,10,0,0,Todas,0,55200
2006-09-15,8,0,0,Todas,0,55208
2006-09-18,18,0,0,Todas,0,55226
2006-09-19,11,0,0,Todas,0,55237
2006-09-20,16,0,0,Todas,0,55253
2006-09-21,14,0,0,Todas,0,55267
2006-09-22,20,0,0,Todas,0,55287
2006-09-24,1,0,0,Todas,0,55288
2006-09-25,10,0,0,Todas,0,55298
2006-09-26,17,0,0,Todas,0,55315
2006-09-27,10,0,0,Todas,0,55325
2006-09-28,13,0,0,Todas,0,55338
2006-09-29,17,0,0,Todas,0,55355
2006-09-30,1,0,0,Todas,0,55356
2006-10-01,1,0,0,Todas,0,55357
2006-10-02,20,0,0,Todas,0,55377
2006-10-03,16,0,0,Todas,0,55393
2006-10-04,14,0,0,Todas,0,55407
2006-10-05,14,0,0,Todas,0,55421
2006-10-06,19,0,0,Todas,0,55440
2006-10-09,1,0,0,Todas,0,55441
2006-10-10,8,0,0,Todas,0,55449
2006-10-11,15,0,0,Todas,0,55464
2006-10-12,13,0,0,Todas,0,55477
2006-10-13,10,0,0,Todas,0,55487
2006-10-16,13,0,0,Todas,0,55500
2006-10-17,12,0,0,Todas,0,55512
2006-10-18,9,0,0,Todas,0,55521
2006-10-19,16,0,0,Todas,0,55537
2006-10-20,9,0,0,Todas,0,55546
2006-10-21,1,0,0,Todas,0,55547
2006-10-23,11,0,0,Todas,0,55558
2006-10-24,13,0,0,Todas,0,55571
2006-10-25,13,0,0,Todas,0,55584
2006-10-26,15,0,0,Todas,0,55599
2006-10-27,16,0,0,Todas,0,55615
2006-10-30,23,0,0,Todas,0,55638
2006-10-31,19,0,0,Todas,0,55657
2006-11-01,16,0,0,Todas,0,55673
2006-11-03,5,0,0,Todas,0,55678
2006-11-06,15,0,0,Todas,0,55693
2006-11-07,5,0,0,Todas,0,55698
2006-11-08,15,0,0,Todas,0,55713
2006-11-09,16,0,0,Todas,0,55729
2006-11-10,10,0,0,Todas,0,55739
2006-11-11,1,0,0,Todas,0,55740
2006-11-13,12,0,0,Todas,0,55752
2006-11-14,20,0,0,Todas,0,55772
2006-11-15,11,0,0,Todas,0,55783
2006-11-16,15,0,0,Todas,0,55798
2006-11-17,10,0,0,Todas,0,55808
2006-11-20,6,0,0,Todas,0,55814
2006-11-21,10,0,0,Todas,0,55824
2006-11-22,19,0,0,Todas,0,55843
2006-11-23,12,0,0,Todas,0,55855
2006-11-24,7,0,0,Todas,0,55862
2006-11-25,1,0,0,Todas,0,55863
2006-11-27,19,0,0,Todas,0,55882
2006-11-28,9,0,0,Todas,0,55891
2006-11-29,15,0,0,Todas,0,55906
2006-11-30,15,0,0,Todas,0,55921
2006-12-01,13,0,0,Todas,0,55934
2006-12-04,10,0,0,Todas,0,55944
2006-12-05,5,0,0,Todas,0,55949
2006-12-06,2,0,0,Todas,0,55951
2006-12-07,10,0,0,Todas,0,55961
2006-12-08,15,0,0,Todas,0,55976
2006-12-11,9,0,0,Todas,0,55985
2006-12-12,7,0,0,Todas,0,55992
2006-12-13,12,0,0,Todas,0,56004
2006-12-14,12,0,0,Todas,0,56016
2006-12-15,13,0,0,Todas,0,56029
2006-12-18,14,0,0,Todas,0,56043
2006-12-19,11,0,0,Todas,0,56054
2006-12-20,14,0,0,Todas,0,56068
2006-12-21,12,0,0,Todas,0,56080
2006-12-22,14,0,0,Todas,0,56094
2006-12-26,15,0,0,Todas,0,56109
2006-12-27,17,0,0,Todas,0,56126
2006-12-28,12,0,0,Todas,0,56138
2006-12-29,10,0,0,Todas,0,56148
2007-01-01,5,0,0,Todas,0,56153
2007-01-02,11,0,0,Todas,0,56164
2007-01-03,8,0,0,Todas,0,56172
2007-01-04,20,0,0,Todas,0,56192
2007-01-05,15,0,0,Todas,0,56207
2007-01-08,10,0,0,Todas,0,56217
2007-01-09,9,0,0,Todas,0,56226
2007-01-10,21,0,0,Todas,0,56247
2007-01-11,18,0,0,Todas,0,56265
2007-01-12,23,0,0,Todas,0,56288
2007-01-13,1,0,0,Todas,0,56289
2007-01-15,18,0,0,Todas,0,56307
2007-01-16,9,0,0,Todas,0,56316
2007-01-17,18,0,0,Todas,0,56334
2007-01-18,15,0,0,Todas,0,56349
2007-01-19,14,0,0,Todas,0,56363
2007-01-22,9,0,0,Todas,0,56372
2007-01-23,10,0,0,Todas,0,56382
2007-01-24,11,0,0,Todas,0,56393
2007-01-25,18,0,0,Todas,0,56411
2007-01-26,16,0,0,Todas,0,56427
2007-01-29,11,0,0,Todas,0,56438
2007-01-30,6,0,0,Todas,0,56444
2007-01-31,13,0,0,Todas,0,56457
2007-02-01,12,0,0,Todas,0,56469
2007-02-02,17,0,0,Todas,0,56486
2007-02-05,11,0,0,Todas,0,56497
2007-02-06,18,0,0,Todas,0,56515
2007-02-07,10,0,0,Todas,0,56525
2007-02-08,13,0,0,Todas,0,56538
2007-02-09,6,0,0,Todas,0,56544
2007-02-12,16,0,0,Todas,0,56560
2007-02-13,12,0,0,Todas,0,56572
2007-02-14,14,0,0,Todas,0,56586
2007-02-15,13,0,0,Todas,0,56599
2007-02-16,9,0,0,Todas,0,56608
2007-02-19,1,0,0,Todas,0,56609
2007-02-21,17,0,0,Todas,0,56626
2007-02-22,12,0,0,Todas,0,56638
2007-02-23,5,0,0,Todas,0,56643
2007-02-26,9,0,0,Todas,0,56652
2007-02-27,13,0,0,Todas,0,56665
2007-02-28,12,0,0,Todas,0,56677
2007-03-01,20,0,0,Todas,0,56697
2007-03-02,12,0,0,Todas,0,56709
2007-03-03,1,0,0,Todas,0,56710
2007-03-05,15,0,0,Todas,0,56725
2007-03-06,17,0,0,Todas,0,56742
2007-03-07,10,0,0,Todas,0,56752
2007-03-08,14,0,0,Todas,0,56766
2007-03-09,15,0,0,Todas,0,56781
2007-03-10,1,0,0,Todas,0,56782
2007-03-11,1,0,0,Todas,0,56783
2007-03-12,14,0,0,Todas,0,56797
2007-03-13,11,0,0,Todas,0,56808
2007-03-14,17,0,0,Todas,0,56825
2007-03-15,15,0,0,Todas,0,56840
2007-03-16,15,0,0,Todas,0,56855
2007-03-17,1,0,0,Todas,0,56856
2007-03-19,11,0,0,Todas,0,56867
2007-03-20,16,0,0,Todas,0,56883
2007-03-21,12,0,0,Todas,0,56895
2007-03-22,12,0,0,Todas,0,56907
2007-03-23,16,0,0,Todas,0,56923
2007-03-26,12,0,0,Todas,0,56935
2007-03-27,12,0,0,Todas,0,56947
2007-03-28,17,0,0,Todas,0,56964
2007-03-29,21,0,0,Todas,0,56985
2007-03-30,9,0,0,Todas,0,56994
2007-04-02,15,0,0,Todas,0,57009
2007-04-03,12,0,0,Todas,0,57021
2007-04-04,8,0,0,Todas,0,57029
2007-04-05,14,0,0,Todas,0,57043
2007-04-09,12,0,0,Todas,0,57055
2007-04-10,15,0,0,Todas,0,57070
2007-04-11,18,0,0,Todas,0,57088
2007-04-12,15,0,0,Todas,0,57103
2007-04-13,13,0,0,Todas,0,57116
2007-04-16,19,0,0,Todas,0,57135
2007-04-17,14,0,0,Todas,0,57149
2007-04-18,11,0,0,Todas,0,57160
2007-04-19,19,0,0,Todas,0,57179
2007-04-20,15,0,0,Todas,0,57194
2007-04-23,14,0,0,Todas,0,57208
2007-04-24,8,0,0,Todas,0,57216
2007-04-25,11,0,0,Todas,0,57227
2007-04-26,20,0,0,Todas,0,57247
2007-04-27,17,0,0,Todas,0,57264
2007-04-30,10,0,0,Todas,0,57274
2007-05-02,12,0,0,Todas,0,57286
2007-05-03,13,0,0,Todas,0,57299
2007-05-04,14,0,0,Todas,0,57313
2007-05-07,13,0,0,Todas,0,57326
2007-05-08,18,0,0,Todas,0,57344
2007-05-09,13,0,0,Todas,0,57357
2007-05-10,16,0,0,Todas,0,57373
2007-05-11,10,0,0,Todas,0,57383
2007-05-14,12,0,0,Todas,0,57395
2007-05-15,10,0,0,Todas,0,57405
2007-05-16,12,0,0,Todas,0,57417
2007-05-17,12,0,0,Todas,0,57429
2007-05-18,11,0,0,Todas,0,57440
2007-05-21,15,0,0,Todas,0,57455
2007-05-22,12,0,0,Todas,0,57467
2007-05-23,20,0,0,Todas,0,57487
2007-05-24,11,0,0,Todas,0,57498
2007-05-28,12,0,0,Todas,0,57510
2007-05-29,15,0,0,Todas,0,57525
2007-05-30,9,0,0,Todas,0,57534
2007-05-31,19,0,0,Todas,0,57553
2007-06-01,12,0,0,Todas,0,57565
2007-06-04,14,0,0,Todas,0,57579
2007-06-05,14,0,0,Todas,0,57593
2007-06-06,14,0,0,Todas,0,57607
2007-06-07,14,0,0,Todas,0,57621
2007-06-08,11,0,0,Todas,0,57632
2007-06-10,1,0,0,Todas,0,57633
2007-06-11,12,0,0,Todas,0,57645
2007-06-12,25,0,0,Todas,0,57670
2007-06-13,14,0,0,Todas,0,57684
2007-06-14,16,0,0,Todas,0,57700
2007-06-15,12,0,0,Todas,0,57712
2007-06-18,21,0,0,Todas,0,57733
2007-06-19,8,0,0,Todas,0,57741
2007-06-20,18,0,0,Todas,0,57759
2007-06-21,12,0,0,Todas,0,57771
2007-06-22,8,0,0,Todas,0,57779
2007-06-25,10,0,0,Todas,0,57789
2007-06-26,21,0,0,Todas,0,57810
2007-06-27,13,0,0,Todas,0,57823
2007-06-28,12,0,0,Todas,0,57835
2007-06-29,16,0,0,Todas,0,57851
2007-07-02,14,0,0,Todas,0,57865
2007-07-03,10,0,0,Todas,0,57875
2007-07-04,12,0,0,Todas,0,57887
2007-07-05,14,0,0,Todas,0,57901
2007-07-06,17,0,0,Todas,0,57918
2007-07-07,1,0,0,Todas,0,57919
2007-07-09,14,0,0,Todas,0,57933
2007-07-10,19,0,0,Todas,0,57952
2007-07-11,22,0,0,Todas,0,57974
2007-07-12,22,0,0,Todas,0,57996
2007-07-13,10,0,0,Todas,0,58006
2007-07-16,19,0,0,Todas,0,58025
2007-07-17,20,0,0,Todas,0,58045
2007-07-18,24,0,0,Todas,0,58069
2007-07-19,15,0,0,Todas,0,58084
2007-07-20,12,0,0,Todas,0,58096
2007-07-23,18,0,0,Todas,0,58114
2007-07-24,14,0,0,Todas,0,58128
2007-07-25,15,0,0,Todas,0,58143
2007-07-26,27,0,0,Todas,0,58170
2007-07-27,22,0,0,Todas,0,58192
2007-07-30,16,0,0,Todas,0,58208
2007-07-31,16,0,0,Todas,0,58224
2007-08-01,27,0,0,Todas,0,58251
2007-08-02,26,0,0,Todas,0,58277
2007-08-03,11,0,0,Todas,0,58288
2007-08-06,9,0,0,Todas,0,58297
2007-08-07,21,0,0,Todas,0,58318
2007-08-08,21,0,0,Todas,0,58339
2007-08-09,10,0,0,Todas,0,58349
2007-08-12,1,0,0,Todas,0,58350
2007-08-13,10,0,0,Todas,0,58360
2007-08-14,15,0,0,Todas,0,58375
2007-08-15,21,0,0,Todas,0,58396
2007-08-16,16,0,0,Todas,0,58412
2007-08-17,5,0,0,Todas,0,58417
2007-08-18,1,0,0,Todas,0,58418
2007-08-20,10,0,0,Todas,0,58428
2007-08-21,13,0,0,Todas,0,58441
2007-08-22,15,0,0,Todas,0,58456
2007-08-23,8,0,0,Todas,0,58464
2007-08-24,12,0,0,Todas,0,58476
2007-08-27,13,0,0,Todas,0,58489
2007-08-28,18,0,0,Todas,0,58507
2007-08-29,25,0,0,Todas,0,58532
2007-08-30,12,0,0,Todas,0,58544
2007-08-31,11,0,0,Todas,0,58555
2007-09-01,3,0,0,Todas,0,58558
2007-09-03,10,0,0,Todas,0,58568
2007-09-04,8,0,0,Todas,0,58576
2007-09-05,15,0,0,Todas,0,58591
2007-09-06,17,0,0,Todas,0,58608
2007-09-07,9,0,0,Todas,0,58617
2007-09-08,1,0,0,Todas,0,58618
2007-09-10,9,0,0,Todas,0,58627
2007-09-11,9,0,0,Todas,0,58636
2007-09-12,19,0,0,Todas,0,58655
2007-09-13,14,0,0,Todas,0,58669
2007-09-14,15,0,0,Todas,0,58684
2007-09-15,1,0,0,Todas,0,58685
2007-09-17,8,0,0,Todas,0,58693
2007-09-18,8,0,0,Todas,0,58701
2007-09-19,13,0,0,Todas,0,58714
2007-09-20,8,0,0,Todas,0,58722
2007-09-21,21,0,0,Todas,0,58743
2007-09-23,1,0,0,Todas,0,58744
2007-09-24,18,0,0,Todas,0,58762
2007-09-25,7,0,0,Todas,0,58769
2007-09-26,9,0,0,Todas,0,58778
2007-09-27,11,0,0,Todas,0,58789
2007-09-28,8,0,0,Todas,0,58797
2007-09-29,1,0,0,Todas,0,58798
2007-10-01,14,0,0,Todas,0,58812
2007-10-02,8,0,0,Todas,0,58820
2007-10-03,7,0,0,Todas,0,58827
2007-10-04,15,0,0,Todas,0,58842
2007-10-05,13,0,0,Todas,0,58855
2007-10-08,4,0,0,Todas,0,58859
2007-10-09,13,0,0,Todas,0,58872
2007-10-10,12,0,0,Todas,0,58884
2007-10-11,18,0,0,Todas,0,58902
2007-10-15,15,0,0,Todas,0,58917
2007-10-16,14,0,0,Todas,0,58931
2007-10-17,11,0,0,Todas,0,58942
2007-10-18,13,0,0,Todas,0,58955
2007-10-19,12,0,0,Todas,0,58967
2007-10-20,1,0,0,Todas,0,58968
2007-10-21,1,0,0,Todas,0,58969
2007-10-22,16,0,0,Todas,0,58985
2007-10-23,10,0,0,Todas,0,58995
2007-10-24,19,0,0,Todas,0,59014
2007-10-25,15,0,0,Todas,0,59029
2007-10-26,17,0,0,Todas,0,59046
2007-10-29,23,0,0,Todas,0,59069
2007-10-30,14,0,0,Todas,0,59083
2007-10-31,14,0,0,Todas,0,59097
2007-11-01,23,0,0,Todas,0,59120
2007-11-02,1,0,0,Todas,0,59121
2007-11-05,7,0,0,Todas,0,59128
2007-11-06,9,0,0,Todas,0,59137
2007-11-07,12,0,0,Todas,0,59149
2007-11-08,16,0,0,Todas,0,59165
2007-11-09,15,0,0,Todas,0,59180
2007-11-11,6,0,0,Todas,0,59186
2007-11-12,10,0,0,Todas,0,59196
2007-11-13,10,0,0,Todas,0,59206
2007-11-14,14,0,0,Todas,0,59220
2007-11-15,12,0,0,Todas,0,59232
2007-11-16,18,0,0,Todas,0,59250
2007-11-19,15,0,0,Todas,0,59265
2007-11-20,18,0,0,Todas,0,59283
2007-11-21,8,0,0,Todas,0,59291
2007-11-22,13,0,0,Todas,0,59304
2007-11-23,12,0,0,Todas,0,59316
2007-11-26,10,0,0,Todas,0,59326
2007-11-27,15,0,0,Todas,0,59341
2007-11-28,11,0,0,Todas,0,59352
2007-11-29,11,0,0,Todas,0,59363
2007-11-30,13,0,0,Todas,0,59376
2007-12-03,10,0,0,Todas,0,59386
2007-12-04,8,0,0,Todas,0,59394
2007-12-05,3,0,0,Todas,0,59397
2007-12-07,13,0,0,Todas,0,59410
2007-12-10,12,0,0,Todas,0,59422
2007-12-11,8,0,0,Todas,0,59430
2007-12-12,13,0,0,Todas,0,59443
2007-12-13,8,0,0,Todas,0,59451
2007-12-14,13,0,0,Todas,0,59464
2007-12-17,16,0,0,Todas,0,59480
2007-12-18,12,0,0,Todas,0,59492
2007-12-19,9,0,0,Todas,0,59501
2007-12-20,18,0,0,Todas,0,59519
2007-12-21,19,0,0,Todas,0,59538
2007-12-22,5,0,0,Todas,0,59543
2007-12-26,12,0,0,Todas,0,59555
2007-12-27,13,0,0,Todas,0,59568
2007-12-28,14,0,0,Todas,0,59582
2007-12-29,8,0,0,Todas,0,59590
2008-01-01,42,0,0,Todas,0,59632
2008-01-02,19,0,0,Todas,0,59651
2008-01-03,13,0,0,Todas,0,59664
2008-01-04,12,0,0,Todas,0,59676
2008-01-07,9,0,0,Todas,0,59685
2008-01-08,9,0,0,Todas,0,59694
2008-01-09,22,0,0,Todas,0,59716
2008-01-10,22,0,0,Todas,0,59738
2008-01-11,11,0,0,Todas,0,59749
2008-01-14,13,0,0,Todas,0,59762
2008-01-15,10,0,0,Todas,0,59772
2008-01-16,9,0,0,Todas,0,59781
2008-01-17,11,0,0,Todas,0,59792
2008-01-18,17,0,0,Todas,0,59809
2008-01-20,1,0,0,Todas,0,59810
2008-01-21,12,0,0,Todas,0,59822
2008-01-22,21,0,0,Todas,0,59843
2008-01-23,10,0,0,Todas,0,59853
2008-01-24,13,0,0,Todas,0,59866
2008-01-25,8,0,0,Todas,0,59874
2008-01-28,9,0,0,Todas,0,59883
2008-01-29,7,0,0,Todas,0,59890
2008-01-30,14,0,0,Todas,0,59904
2008-01-31,11,0,0,Todas,0,59915
2008-02-01,19,0,0,Todas,0,59934
2008-02-06,12,0,0,Todas,0,59946
2008-02-07,11,0,0,Todas,0,59957
2008-02-08,18,0,0,Todas,0,59975
2008-02-09,3,0,0,Todas,0,59978
2008-02-10,1,0,0,Todas,0,59979
2008-02-11,21,0,0,Todas,0,60000
2008-02-12,15,0,0,Todas,0,60015
2008-02-13,10,0,0,Todas,0,60025
2008-02-14,11,0,0,Todas,0,60036
2008-02-15,17,0,0,Todas,0,60053
2008-02-16,4,0,0,Todas,0,60057
2008-02-18,16,0,0,Todas,0,60073
2008-02-19,15,0,0,Todas,0,60088
2008-02-20,16,0,0,Todas,0,60104
2008-02-21,10,0,0,Todas,0,60114
2008-02-22,17,0,0,Todas,0,60131
2008-02-25,13,0,0,Todas,0,60144
2008-02-26,10,0,0,Todas,0,60154
2008-02-27,10,0,0,Todas,0,60164
2008-02-28,18,0,0,Todas,0,60182
2008-02-29,15,0,0,Todas,0,60197
2008-03-01,3,0,0,Todas,0,60200
2008-03-03,12,0,0,Todas,0,60212
2008-03-04,15,0,0,Todas,0,60227
2008-03-05,16,0,0,Todas,0,60243
2008-03-06,15,0,0,Todas,0,60258
2008-03-07,7,0,0,Todas,0,60265
2008-03-08,1,0,0,Todas,0,60266
2008-03-10,17,0,0,Todas,0,60283
2008-03-11,12,0,0,Todas,0,60295
2008-03-12,13,0,0,Todas,0,60308
2008-03-13,6,0,0,Todas,0,60314
2008-03-14,16,0,0,Todas,0,60330
2008-03-15,1,0,0,Todas,0,60331
2008-03-17,14,0,0,Todas,0,60345
2008-03-18,12,0,0,Todas,0,60357
2008-03-19,17,0,0,Todas,0,60374
2008-03-20,15,0,0,Todas,0,60389
2008-03-24,6,0,0,Todas,0,60395
2008-03-25,9,0,0,Todas,0,60404
2008-03-26,16,0,0,Todas,0,60420
2008-03-27,17,0,0,Todas,0,60437
2008-03-28,24,0,0,Todas,0,60461
2008-03-31,15,0,0,Todas,0,60476
2008-04-01,17,0,0,Todas,0,60493
2008-04-02,10,0,0,Todas,0,60503
2008-04-03,18,0,0,Todas,0,60521
2008-04-04,14,0,0,Todas,0,60535
2008-04-07,12,0,0,Todas,0,60547
2008-04-08,18,0,0,Todas,0,60565
2008-04-09,11,0,0,Todas,0,60576
2008-04-10,17,0,0,Todas,0,60593
2008-04-11,20,0,0,Todas,0,60613
2008-04-14,13,0,0,Todas,0,60626
2008-04-15,12,0,0,Todas,0,60638
2008-04-16,20,0,0,Todas,0,60658
2008-04-17,16,0,0,Todas,0,60674
2008-04-18,12,0,0,Todas,0,60686
2008-04-21,9,0,0,Todas,0,60695
2008-04-22,12,0,0,Todas,0,60707
2008-04-23,14,0,0,Todas,0,60721
2008-04-24,12,0,0,Todas,0,60733
2008-04-25,17,0,0,Todas,0,60750
2008-04-28,17,0,0,Todas,0,60767
2008-04-29,9,0,0,Todas,0,60776
2008-04-30,14,0,0,Todas,0,60790
2008-05-02,2,0,0,Todas,0,60792
2008-05-05,14,0,0,Todas,0,60806
2008-05-06,14,0,0,Todas,0,60820
2008-05-07,17,0,0,Todas,0,60837
2008-05-08,9,0,0,Todas,0,60846
2008-05-09,15,0,0,Todas,0,60861
2008-05-12,15,0,0,Todas,0,60876
2008-05-13,12,0,0,Todas,0,60888
2008-05-14,18,0,0,Todas,0,60906
2008-05-15,12,0,0,Todas,0,60918
2008-05-16,17,0,0,Todas,0,60935
2008-05-17,2,0,0,Todas,0,60937
2008-05-19,8,0,0,Todas,0,60945
2008-05-20,19,0,0,Todas,0,60964
2008-05-21,18,0,0,Todas,0,60982
2008-05-22,18,0,0,Todas,0,61000
2008-05-23,20,0,0,Todas,0,61020
2008-05-25,2,0,0,Todas,0,61022
2008-05-26,17,0,0,Todas,0,61039
2008-05-27,10,0,0,Todas,0,61049
2008-05-28,14,0,0,Todas,0,61063
2008-05-29,20,0,0,Todas,0,61083
2008-05-30,13,0,0,Todas,0,61096
2008-06-02,12,0,0,Todas,0,61108
2008-06-03,11,0,0,Todas,0,61119
2008-06-04,9,0,0,Todas,0,61128
2008-06-05,18,0,0,Todas,0,61146
2008-06-06,10,0,0,Todas,0,61156
2008-06-09,17,0,0,Todas,0,61173
2008-06-10,19,0,0,Todas,0,61192
2008-06-11,17,0,0,Todas,0,61209
2008-06-12,26,0,0,Todas,0,61235
2008-06-13,15,0,0,Todas,0,61250
2008-06-16,22,0,0,Todas,0,61272
2008-06-17,18,0,0,Todas,0,61290
2008-06-18,11,0,0,Todas,0,61301
2008-06-19,14,0,0,Todas,0,61315
2008-06-20,12,0,0,Todas,0,61327
2008-06-23,14,0,0,Todas,0,61341
2008-06-24,12,0,0,Todas,0,61353
2008-06-25,14,0,0,Todas,0,61367
2008-06-26,13,0,0,Todas,0,61380
2008-06-27,19,0,0,Todas,0,61399
2008-06-30,13,0,0,Todas,0,61412
2008-07-01,15,0,0,Todas,0,61427
2008-07-02,10,0,0,Todas,0,61437
2008-07-03,13,0,0,Todas,0,61450
2008-07-04,16,0,0,Todas,0,61466
2008-07-07,15,0,0,Todas,0,61481
2008-07-08,12,0,0,Todas,0,61493
2008-07-09,15,0,0,Todas,0,61508
2008-07-10,11,0,0,Todas,0,61519
2008-07-11,13,0,0,Todas,0,61532
2008-07-14,15,0,0,Todas,0,61547
2008-07-15,15,0,0,Todas,0,61562
2008-07-16,15,0,0,Todas,0,61577
2008-07-17,22,0,0,Todas,0,61599
2008-07-18,9,0,0,Todas,0,61608
2008-07-21,13,0,0,Todas,0,61621
2008-07-22,19,0,0,Todas,0,61640
2008-07-23,16,0,0,Todas,0,61656
2008-07-24,22,0,0,Todas,0,61678
2008-07-25,4,0,0,Todas,0,61682
2008-07-26,1,0,0,Todas,0,61683
2008-07-28,15,0,0,Todas,0,61698
2008-07-29,8,0,0,Todas,0,61706
2008-07-30,23,0,0,Todas,0,61729
2008-07-31,16,0,0,Todas,0,61745
2008-08-01,14,0,0,Todas,0,61759
2008-08-04,11,0,0,Todas,0,61770
2008-08-05,18,0,0,Todas,0,61788
2008-08-06,13,0,0,Todas,0,61801
2008-08-07,7,0,0,Todas,0,61808
2008-08-08,21,0,0,Todas,0,61829
2008-08-09,1,0,0,Todas,0,61830
2008-08-11,17,0,0,Todas,0,61847
2008-08-12,64,0,0,Todas,0,61911
2008-08-13,17,0,0,Todas,0,61928
2008-08-14,15,0,0,Todas,0,61943
2008-08-15,14,0,0,Todas,0,61957
2008-08-18,14,0,0,Todas,0,61971
2008-08-19,8,0,0,Todas,0,61979
2008-08-20,13,0,0,Todas,0,61992
2008-08-21,15,0,0,Todas,0,62007
2008-08-22,7,0,0,Todas,0,62014
2008-08-25,6,0,0,Todas,0,62020
2008-08-26,10,0,0,Todas,0,62030
2008-08-27,13,0,0,Todas,0,62043
2008-08-28,11,0,0,Todas,0,62054
2008-08-29,22,0,0,Todas,0,62076
2008-09-01,10,0,0,Todas,0,62086
2008-09-02,15,0,0,Todas,0,62101
2008-09-03,14,0,0,Todas,0,62115
2008-09-04,16,0,0,Todas,0,62131
2008-09-05,5,0,0,Todas,0,62136
2008-09-08,14,0,0,Todas,0,62150
2008-09-09,13,0,0,Todas,0,62163
2008-09-10,19,0,0,Todas,0,62182
2008-09-11,20,0,0,Todas,0,62202
2008-09-12,17,0,0,Todas,0,62219
2008-09-15,12,0,0,Todas,0,62231
2008-09-16,17,0,0,Todas,0,62248
2008-09-17,12,0,0,Todas,0,62260
2008-09-18,18,0,0,Todas,0,62278
2008-09-19,18,0,0,Todas,0,62296
2008-09-22,11,0,0,Todas,0,62307
2008-09-23,18,0,0,Todas,0,62325
2008-09-24,22,0,0,Todas,0,62347
2008-09-25,8,0,0,Todas,0,62355
2008-09-26,6,0,0,Todas,0,62361
2008-09-29,10,0,0,Todas,0,62371
2008-09-30,13,0,0,Todas,0,62384
2008-10-01,24,0,0,Todas,0,62408
2008-10-02,14,0,0,Todas,0,62422
2008-10-03,13,0,0,Todas,0,62435
2008-10-06,13,0,0,Todas,0,62448
2008-10-07,9,0,0,Todas,0,62457
2008-10-08,10,0,0,Todas,0,62467
2008-10-09,16,0,0,Todas,0,62483
2008-10-13,12,0,0,Todas,0,62495
2008-10-14,17,0,0,Todas,0,62512
2008-10-15,18,0,0,Todas,0,62530
2008-10-16,6,0,0,Todas,0,62536
2008-10-17,11,0,0,Todas,0,62547
2008-10-18,1,0,0,Todas,0,62548
2008-10-20,16,0,0,Todas,0,62564
2008-10-21,9,0,0,Todas,0,62573
2008-10-22,19,0,0,Todas,0,62592
2008-10-23,13,0,0,Todas,0,62605
2008-10-24,18,0,0,Todas,0,62623
2008-10-27,15,0,0,Todas,0,62638
2008-10-28,10,0,0,Todas,0,62648
2008-10-29,11,0,0,Todas,0,62659
2008-10-30,15,0,0,Todas,0,62674
2008-10-31,11,0,0,Todas,0,62685
2008-11-04,7,0,0,Todas,0,62692
2008-11-05,12,0,0,Todas,0,62704
2008-11-06,17,0,0,Todas,0,62721
2008-11-07,9,0,0,Todas,0,62730
2008-11-10,19,0,0,Todas,0,62749
2008-11-11,15,0,0,Todas,0,62764
2008-11-12,15,0,0,Todas,0,62779
2008-11-13,13,0,0,Todas,0,62792
2008-11-14,12,0,0,Todas,0,62804
2008-11-17,15,0,0,Todas,0,62819
2008-11-18,10,0,0,Todas,0,62829
2008-11-19,19,0,0,Todas,0,62848
2008-11-20,46,0,0,Todas,0,62894
2008-11-21,12,0,0,Todas,0,62906
2008-11-24,15,0,0,Todas,0,62921
2008-11-25,17,0,0,Todas,0,62938
2008-11-26,8,0,0,Todas,0,62946
2008-11-27,24,0,0,Todas,0,62970
2008-11-28,24,0,0,Todas,0,62994
2008-12-01,9,0,0,Todas,0,63003
2008-12-02,32,0,0,Todas,0,63035
2008-12-03,15,0,0,Todas,0,63050
2008-12-04,16,0,0,Todas,0,63066
2008-12-05,5,0,0,Todas,0,63071
2008-12-06,2,0,0,Todas,0,63073
2008-12-08,12,0,0,Todas,0,63085
2008-12-09,11,0,0,Todas,0,63096
2008-12-10,14,0,0,Todas,0,63110
2008-12-11,20,0,0,Todas,0,63130
2008-12-12,18,0,0,Todas,0,63148
2008-12-15,10,0,0,Todas,0,63158
2008-12-16,20,0,0,Todas,0,63178
2008-12-17,12,0,0,Todas,0,63190
2008-12-18,16,0,0,Todas,0,63206
2008-12-19,9,0,0,Todas,0,63215
2008-12-22,19,0,0,Todas,0,63234
2008-12-23,8,0,0,Todas,0,63242
2008-12-24,3,0,0,Todas,0,63245
2008-12-29,5,0,0,Todas,0,63250
2008-12-30,15,0,0,Todas,0,63265
2008-12-31,9,0,0,Todas,0,63274
2009-01-01,2,0,0,Todas,0,63276
2009-01-04,1,0,0,Todas,0,63277
2009-01-05,146,0,0,Todas,0,63423
2009-01-06,10,0,0,Todas,0,63433
2009-01-07,8,0,0,Todas,0,63441
2009-01-08,6,0,0,Todas,0,63447
2009-01-09,17,0,0,Todas,0,63464
2009-01-12,13,0,0,Todas,0,63477
2009-01-13,12,0,0,Todas,0,63489
2009-01-14,12,0,0,Todas,0,63501
2009-01-15,13,0,0,Todas,0,63514
2009-01-16,12,0,0,Todas,0,63526
2009-01-19,11,0,0,Todas,0,63537
2009-01-20,13,0,0,Todas,0,63550
2009-01-21,9,0,0,Todas,0,63559
2009-01-22,14,0,0,Todas,0,63573
2009-01-23,23,0,0,Todas,0,63596
2009-01-25,1,0,0,Todas,0,63597
2009-01-26,9,0,0,Todas,0,63606
2009-01-27,10,0,0,Todas,0,63616
2009-01-28,18,0,0,Todas,0,63634
2009-01-29,16,0,0,Todas,0,63650
2009-01-30,16,0,0,Todas,0,63666
2009-02-02,17,0,0,Todas,0,63683
2009-02-03,18,0,0,Todas,0,63701
2009-02-04,11,0,0,Todas,0,63712
2009-02-05,20,0,0,Todas,0,63732
2009-02-06,12,0,0,Todas,0,63744
2009-02-07,2,0,0,Todas,0,63746
2009-02-08,1,0,0,Todas,0,63747
2009-02-09,21,0,0,Todas,0,63768
2009-02-10,18,0,0,Todas,0,63786
2009-02-11,13,0,0,Todas,0,63799
2009-02-12,22,0,0,Todas,0,63821
2009-02-13,15,0,0,Todas,0,63836
2009-02-16,16,0,0,Todas,0,63852
2009-02-17,11,0,0,Todas,0,63863
2009-02-18,9,0,0,Todas,0,63872
2009-02-19,18,0,0,Todas,0,63890
2009-02-20,18,0,0,Todas,0,63908
2009-02-25,17,0,0,Todas,0,63925
2009-02-26,17,0,0,Todas,0,63942
2009-02-27,17,0,0,Todas,0,63959
2009-02-28,3,0,0,Todas,0,63962
2009-03-01,1,0,0,Todas,0,63963
2009-03-02,21,0,0,Todas,0,63984
2009-03-03,15,0,0,Todas,0,63999
2009-03-04,19,0,0,Todas,0,64018
2009-03-05,24,0,0,Todas,0,64042
2009-03-06,22,0,0,Todas,0,64064
2009-03-07,6,0,0,Todas,0,64070
2009-03-09,13,0,0,Todas,0,64083
2009-03-10,23,0,0,Todas,0,64106
2009-03-11,22,0,0,Todas,0,64128
2009-03-12,17,0,0,Todas,0,64145
2009-03-13,10,0,0,Todas,0,64155
2009-03-15,1,0,0,Todas,0,64156
2009-03-16,22,0,0,Todas,0,64178
2009-03-17,24,0,0,Todas,0,64202
2009-03-18,13,0,0,Todas,0,64215
2009-03-19,22,0,0,Todas,0,64237
2009-03-20,14,0,0,Todas,0,64251
2009-03-22,1,0,0,Todas,0,64252
2009-03-23,16,0,0,Todas,0,64268
2009-03-24,19,0,0,Todas,0,64287
2009-03-25,18,0,0,Todas,0,64305
2009-03-26,24,0,0,Todas,0,64329
2009-03-27,14,0,0,Todas,0,64343
2009-03-30,14,0,0,Todas,0,64357
2009-03-31,14,0,0,Todas,0,64371
2009-04-01,13,0,0,Todas,0,64384
2009-04-02,14,0,0,Todas,0,64398
2009-04-03,14,0,0,Todas,0,64412
2009-04-06,21,0,0,Todas,0,64433
2009-04-07,17,0,0,Todas,0,64450
2009-04-08,21,0,0,Todas,0,64471
2009-04-09,10,0,0,Todas,0,64481
2009-04-13,16,0,0,Todas,0,64497
2009-04-14,10,0,0,Todas,0,64507
2009-04-15,6,0,0,Todas,0,64513
2009-04-16,12,0,0,Todas,0,64525
2009-04-17,14,0,0,Todas,0,64539
2009-04-20,22,0,0,Todas,0,64561
2009-04-21,17,0,0,Todas,0,64578
2009-04-22,7,0,0,Todas,0,64585
2009-04-23,9,0,0,Todas,0,64594
2009-04-24,12,0,0,Todas,0,64606
2009-04-27,15,0,0,Todas,0,64621
2009-04-28,16,0,0,Todas,0,64637
2009-04-29,11,0,0,Todas,0,64648
2009-04-30,12,0,0,Todas,0,64660
2009-05-02,1,0,0,Todas,0,64661
2009-05-04,14,0,0,Todas,0,64675
2009-05-05,19,0,0,Todas,0,64694
2009-05-06,20,0,0,Todas,0,64714
2009-05-07,14,0,0,Todas,0,64728
2009-05-08,9,0,0,Todas,0,64737
2009-05-11,11,0,0,Todas,0,64748
2009-05-12,23,0,0,Todas,0,64771
2009-05-13,17,0,0,Todas,0,64788
2009-05-14,16,0,0,Todas,0,64804
2009-05-15,15,0,0,Todas,0,64819
2009-05-17,1,0,0,Todas,0,64820
2009-05-18,14,0,0,Todas,0,64834
2009-05-19,18,0,0,Todas,0,64852
2009-05-20,8,0,0,Todas,0,64860
2009-05-21,17,0,0,Todas,0,64877
2009-05-22,14,0,0,Todas,0,64891
2009-05-25,17,0,0,Todas,0,64908
2009-05-26,18,0,0,Todas,0,64926
2009-05-27,8,0,0,Todas,0,64934
2009-05-28,18,0,0,Todas,0,64952
2009-05-29,15,0,0,Todas,0,64967
2009-06-01,15,0,0,Todas,0,64982
2009-06-02,11,0,0,Todas,0,64993
2009-06-03,19,0,0,Todas,0,65012
2009-06-04,16,0,0,Todas,0,65028
2009-06-05,10,0,0,Todas,0,65038
2009-06-06,1,0,0,Todas,0,65039
2009-06-08,9,0,0,Todas,0,65048
2009-06-09,10,0,0,Todas,0,65058
2009-06-10,16,0,0,Todas,0,65074
2009-06-11,15,0,0,Todas,0,65089
2009-06-12,18,0,0,Todas,0,65107
2009-06-15,8,0,0,Todas,0,65115
2009-06-16,8,0,0,Todas,0,65123
2009-06-17,10,0,0,Todas,0,65133
2009-06-18,11,0,0,Todas,0,65144
2009-06-19,12,0,0,Todas,0,65156
2009-06-22,21,0,0,Todas,0,65177
2009-06-23,11,0,0,Todas,0,65188
2009-06-24,16,0,0,Todas,0,65204
2009-06-25,23,0,0,Todas,0,65227
2009-06-26,9,0,0,Todas,0,65236
2009-06-29,11,0,0,Todas,0,65247
2009-06-30,22,0,0,Todas,0,65269
2009-07-01,13,0,0,Todas,0,65282
2009-07-02,14,0,0,Todas,0,65296
2009-07-03,15,0,0,Todas,0,65311
2009-07-05,1,0,0,Todas,0,65312
2009-07-06,20,0,0,Todas,0,65332
2009-07-07,15,0,0,Todas,0,65347
2009-07-08,15,0,0,Todas,0,65362
2009-07-09,10,0,0,Todas,0,65372
2009-07-10,10,0,0,Todas,0,65382
2009-07-12,1,0,0,Todas,0,65383
2009-07-13,7,0,0,Todas,0,65390
2009-07-14,13,0,0,Todas,0,65403
2009-07-15,18,0,0,Todas,0,65421
2009-07-16,13,0,0,Todas,0,65434
2009-07-17,6,0,0,Todas,0,65440
2009-07-20,18,0,0,Todas,0,65458
2009-07-21,16,0,0,Todas,0,65474
2009-07-22,6,0,0,Todas,0,65480
2009-07-23,20,0,0,Todas,0,65500
2009-07-24,9,0,0,Todas,0,65509
2009-07-27,12,0,0,Todas,0,65521
2009-07-28,12,0,0,Todas,0,65533
2009-07-29,14,0,0,Todas,0,65547
2009-07-30,15,0,0,Todas,0,65562
2009-07-31,14,0,0,Todas,0,65576
2009-08-03,18,0,0,Todas,0,65594
2009-08-04,20,0,0,Todas,0,65614
2009-08-05,9,0,0,Todas,0,65623
2009-08-06,15,0,0,Todas,0,65638
2009-08-07,15,0,0,Todas,0,65653
2009-08-11,8,0,0,Todas,0,65661
2009-08-12,14,0,0,Todas,0,65675
2009-08-13,19,0,0,Todas,0,65694
2009-08-14,19,0,0,Todas,0,65713
2009-08-15,1,0,0,Todas,0,65714
2009-08-17,16,0,0,Todas,0,65730
2009-08-18,14,0,0,Todas,0,65744
2009-08-19,13,0,0,Todas,0,65757
2009-08-20,13,0,0,Todas,0,65770
2009-08-21,11,0,0,Todas,0,65781
2009-08-24,11,0,0,Todas,0,65792
2009-08-25,11,0,0,Todas,0,65803
2009-08-26,12,0,0,Todas,0,65815
2009-08-27,16,0,0,Todas,0,65831
2009-08-28,18,0,0,Todas,0,65849
2009-08-31,8,0,0,Todas,0,65857
2009-09-01,17,0,0,Todas,0,65874
2009-09-02,12,0,0,Todas,0,65886
2009-09-03,8,0,0,Todas,0,65894
2009-09-04,19,0,0,Todas,0,65913
2009-09-06,1,0,0,Todas,0,65914
2009-09-07,18,0,0,Todas,0,65932
2009-09-08,15,0,0,Todas,0,65947
2009-09-09,17,0,0,Todas,0,65964
2009-09-10,12,0,0,Todas,0,65976
2009-09-11,11,0,0,Todas,0,65987
2009-09-14,10,0,0,Todas,0,65997
2009-09-15,24,0,0,Todas,0,66021
2009-09-16,22,0,0,Todas,0,66043
2009-09-17,15,0,0,Todas,0,66058
2009-09-18,11,0,0,Todas,0,66069
2009-09-21,8,0,0,Todas,0,66077
2009-09-22,19,0,0,Todas,0,66096
2009-09-23,14,0,0,Todas,0,66110
2009-09-24,10,0,0,Todas,0,66120
2009-09-25,16,0,0,Todas,0,66136
2009-09-28,12,0,0,Todas,0,66148
2009-09-29,13,0,0,Todas,0,66161
2009-09-30,15,0,0,Todas,0,66176
2009-10-01,13,0,0,Todas,0,66189
2009-10-02,15,0,0,Todas,0,66204
2009-10-05,12,0,0,Todas,0,66216
2009-10-06,10,0,0,Todas,0,66226
2009-10-07,15,0,0,Todas,0,66241
2009-10-08,13,0,0,Todas,0,66254
2009-10-12,12,0,0,Todas,0,66266
2009-10-13,13,0,0,Todas,0,66279
2009-10-14,12,0,0,Todas,0,66291
2009-10-15,15,0,0,Todas,0,66306
2009-10-16,11,0,0,Todas,0,66317
2009-10-19,19,0,0,Todas,0,66336
2009-10-20,16,0,0,Todas,0,66352
2009-10-21,8,0,0,Todas,0,66360
2009-10-22,24,0,0,Todas,0,66384
2009-10-23,14,0,0,Todas,0,66398
2009-10-25,1,0,0,Todas,0,66399
2009-10-26,12,0,0,Todas,0,66411
2009-10-27,19,0,0,Todas,0,66430
2009-10-28,11,0,0,Todas,0,66441
2009-10-29,19,0,0,Todas,0,66460
2009-10-30,11,0,0,Todas,0,66471
2009-11-04,12,0,0,Todas,0,66483
2009-11-05,15,0,0,Todas,0,66498
2009-11-06,8,0,0,Todas,0,66506
2009-11-09,8,0,0,Todas,0,66514
2009-11-10,13,0,0,Todas,0,66527
2009-11-11,18,0,0,Todas,0,66545
2009-11-12,14,0,0,Todas,0,66559
2009-11-13,12,0,0,Todas,0,66571
2009-11-14,1,0,0,Todas,0,66572
2009-11-16,16,0,0,Todas,0,66588
2009-11-17,13,0,0,Todas,0,66601
2009-11-18,15,0,0,Todas,0,66616
2009-11-19,14,0,0,Todas,0,66630
2009-11-20,8,0,0,Todas,0,66638
2009-11-23,19,0,0,Todas,0,66657
2009-11-24,13,0,0,Todas,0,66670
2009-11-25,18,0,0,Todas,0,66688
2009-11-26,14,0,0,Todas,0,66702
2009-11-27,13,0,0,Todas,0,66715
2009-11-30,14,0,0,Todas,0,66729
2009-12-01,10,0,0,Todas,0,66739
2009-12-02,15,0,0,Todas,0,66754
2009-12-03,9,0,0,Todas,0,66763
2009-12-04,11,0,0,Todas,0,66774
2009-12-07,22,0,0,Todas,0,66796
2009-12-08,11,0,0,Todas,0,66807
2009-12-09,15,0,0,Todas,0,66822
2009-12-10,12,0,0,Todas,0,66834
2009-12-11,11,0,0,Todas,0,66845
2009-12-14,16,0,0,Todas,0,66861
2009-12-15,19,0,0,Todas,0,66880
2009-12-16,13,0,0,Todas,0,66893
2009-12-17,14,0,0,Todas,0,66907
2009-12-18,10,0,0,Todas,0,66917
2009-12-21,19,0,0,Todas,0,66936
2009-12-22,16,0,0,Todas,0,66952
2009-12-23,15,0,0,Todas,0,66967
2009-12-24,2,0,0,Todas,0,66969
2009-12-28,8,0,0,Todas,0,66977
2009-12-29,13,0,0,Todas,0,66990
2009-12-30,17,0,0,Todas,0,67007
2009-12-31,10,0,0,Todas,0,67017
2010-01-01,3,0,0,Todas,0,67020
2010-01-04,8,0,0,Todas,0,67028
2010-01-05,17,0,0,Todas,0,67045
2010-01-06,15,0,0,Todas,0,67060
2010-01-07,17,0,0,Todas,0,67077
2010-01-08,11,0,0,Todas,0,67088
2010-01-11,6,0,0,Todas,0,67094
2010-01-12,14,0,0,Todas,0,67108
2010-01-13,9,0,0,Todas,0,67117
2010-01-14,10,0,0,Todas,0,67127
2010-01-15,21,0,0,Todas,0,67148
2010-01-16,1,0,0,Todas,0,67149
2010-01-18,9,0,0,Todas,0,67158
2010-01-19,8,0,0,Todas,0,67166
2010-01-20,16,0,0,Todas,0,67182
2010-01-21,13,0,0,Todas,0,67195
2010-01-22,16,0,0,Todas,0,67211
2010-01-25,17,0,0,Todas,0,67228
2010-01-26,11,0,0,Todas,0,67239
2010-01-27,11,0,0,Todas,0,67250
2010-01-28,13,0,0,Todas,0,67263
2010-01-29,15,0,0,Todas,0,67278
2010-01-31,2,0,0,Todas,0,67280
2010-02-01,10,0,0,Todas,0,67290
2010-02-02,16,0,0,Todas,0,67306
2010-02-03,15,0,0,Todas,0,67321
2010-02-04,14,0,0,Todas,0,67335
2010-02-05,17,0,0,Todas,0,67352
2010-02-08,14,0,0,Todas,0,67366
2010-02-09,21,0,0,Todas,0,67387
2010-02-10,10,0,0,Todas,0,67397
2010-02-11,16,0,0,Todas,0,67413
2010-02-12,17,0,0,Todas,0,67430
2010-02-17,10,0,0,Todas,0,67440
2010-02-18,16,0,0,Todas,0,67456
2010-02-19,12,0,0,Todas,0,67468
2010-02-20,1,0,0,Todas,0,67469
2010-02-22,13,0,0,Todas,0,67482
2010-02-23,19,0,0,Todas,0,67501
2010-02-24,10,0,0,Todas,0,67511
2010-02-25,13,0,0,Todas,0,67524
2010-02-26,20,0,0,Todas,0,67544
2010-02-27,6,0,0,Todas,0,67550
2010-02-28,1,0,0,Todas,0,67551
2010-03-01,16,0,0,Todas,0,67567
2010-03-02,17,0,0,Todas,0,67584
2010-03-03,25,0,0,Todas,0,67609
2010-03-04,16,0,0,Todas,0,67625
2010-03-05,18,0,0,Todas,0,67643
2010-03-08,11,0,0,Todas,0,67654
2010-03-09,10,0,0,Todas,0,67664
2010-03-10,19,0,0,Todas,0,67683
2010-03-11,15,0,0,Todas,0,67698
2010-03-12,17,0,0,Todas,0,67715
2010-03-15,20,0,0,Todas,0,67735
2010-03-16,16,0,0,Todas,0,67751
2010-03-17,19,0,0,Todas,0,67770
2010-03-18,9,0,0,Todas,0,67779
2010-03-19,19,0,0,Todas,0,67798
2010-03-22,11,0,0,Todas,0,67809
2010-03-23,17,0,0,Todas,0,67826
2010-03-24,11,0,0,Todas,0,67837
2010-03-25,21,0,0,Todas,0,67858
2010-03-26,14,0,0,Todas,0,67872
2010-03-28,2,0,0,Todas,0,67874
2010-03-29,15,0,0,Todas,0,67889
2010-03-30,12,0,0,Todas,0,67901
2010-03-31,15,0,0,Todas,0,67916
2010-04-01,11,0,0,Todas,0,67927
2010-04-04,1,0,0,Todas,0,67928
2010-04-05,19,0,0,Todas,0,67947
2010-04-06,21,0,0,Todas,0,67968
2010-04-07,23,0,0,Todas,0,67991
2010-04-08,12,0,0,Todas,0,68003
2010-04-09,14,0,0,Todas,0,68017
2010-04-10,1,0,0,Todas,0,68018
2010-04-11,1,0,0,Todas,0,68019
2010-04-12,15,0,0,Todas,0,68034
2010-04-13,14,0,0,Todas,0,68048
2010-04-14,21,0,0,Todas,0,68069
2010-04-15,14,0,0,Todas,0,68083
2010-04-16,25,0,0,Todas,0,68108
2010-04-19,18,0,0,Todas,0,68126
2010-04-20,19,0,0,Todas,0,68145
2010-04-21,12,0,0,Todas,0,68157
2010-04-22,13,0,0,Todas,0,68170
2010-04-23,17,0,0,Todas,0,68187
2010-04-26,8,0,0,Todas,0,68195
2010-04-27,20,0,0,Todas,0,68215
2010-04-28,12,0,0,Todas,0,68227
2010-04-29,9,0,0,Todas,0,68236
2010-04-30,15,0,0,Todas,0,68251
2010-05-01,1,0,0,Todas,0,68252
2010-05-03,12,0,0,Todas,0,68264
2010-05-04,9,0,0,Todas,0,68273
2010-05-05,14,0,0,Todas,0,68287
2010-05-06,19,0,0,Todas,0,68306
2010-05-07,18,0,0,Todas,0,68324
2010-05-10,14,0,0,Todas,0,68338
2010-05-11,16,0,0,Todas,0,68354
2010-05-12,15,0,0,Todas,0,68369
2010-05-13,15,0,0,Todas,0,68384
2010-05-14,17,0,0,Todas,0,68401
2010-05-17,21,0,0,Todas,0,68422
2010-05-18,20,0,0,Todas,0,68442
2010-05-19,21,0,0,Todas,0,68463
2010-05-20,13,0,0,Todas,0,68476
2010-05-21,9,0,0,Todas,0,68485
2010-05-25,10,0,0,Todas,0,68495
2010-05-26,15,0,0,Todas,0,68510
2010-05-27,14,0,0,Todas,0,68524
2010-05-28,16,0,0,Todas,0,68540
2010-05-31,16,0,0,Todas,0,68556
2010-06-01,17,0,0,Todas,0,68573
2010-06-02,10,0,0,Todas,0,68583
2010-06-03,22,0,0,Todas,0,68605
2010-06-04,13,0,0,Todas,0,68618
2010-06-07,20,0,0,Todas,0,68638
2010-06-08,15,0,0,Todas,0,68653
2010-06-09,13,0,0,Todas,0,68666
2010-06-10,24,0,0,Todas,0,68690
2010-06-11,18,0,0,Todas,0,68708
2010-06-14,21,0,0,Todas,0,68729
2010-06-15,22,0,0,Todas,0,68751
2010-06-16,14,0,0,Todas,0,68765
2010-06-17,13,0,0,Todas,0,68778
2010-06-18,21,0,0,Todas,0,68799
2010-06-21,21,0,0,Todas,0,68820
2010-06-22,14,0,0,Todas,0,68834
2010-06-23,12,0,0,Todas,0,68846
2010-06-24,15,0,0,Todas,0,68861
2010-06-25,18,0,0,Todas,0,68879
2010-06-28,11,0,0,Todas,0,68890
2010-06-29,9,0,0,Todas,0,68899
2010-06-30,20,0,0,Todas,0,68919
2010-07-01,23,0,0,Todas,0,68942
2010-07-02,10,0,0,Todas,0,68952
2010-07-05,8,0,0,Todas,0,68960
2010-07-06,11,0,0,Todas,0,68971
2010-07-07,18,0,0,Todas,0,68989
2010-07-08,19,0,0,Todas,0,69008
2010-07-09,13,0,0,Todas,0,69021
2010-07-12,15,0,0,Todas,0,69036
2010-07-13,16,0,0,Todas,0,69052
2010-07-14,12,0,0,Todas,0,69064
2010-07-15,8,0,0,Todas,0,69072
2010-07-16,15,0,0,Todas,0,69087
2010-07-19,16,0,0,Todas,0,69103
2010-07-20,15,0,0,Todas,0,69118
2010-07-21,13,0,0,Todas,0,69131
2010-07-22,11,0,0,Todas,0,69142
2010-07-23,17,0,0,Todas,0,69159
2010-07-26,13,0,0,Todas,0,69172
2010-07-27,19,0,0,Todas,0,69191
2010-07-28,12,0,0,Todas,0,69203
2010-07-29,20,0,0,Todas,0,69223
2010-07-30,7,0,0,Todas,0,69230
2010-08-02,17,0,0,Todas,0,69247
2010-08-03,12,0,0,Todas,0,69259
2010-08-04,21,0,0,Todas,0,69280
2010-08-05,14,0,0,Todas,0,69294
2010-08-06,13,0,0,Todas,0,69307
2010-08-09,15,0,0,Todas,0,69322
2010-08-10,10,0,0,Todas,0,69332
2010-08-11,21,0,0,Todas,0,69353
2010-08-12,11,0,0,Todas,0,69364
2010-08-16,13,0,0,Todas,0,69377
2010-08-17,9,0,0,Todas,0,69386
2010-08-18,7,0,0,Todas,0,69393
2010-08-19,3,0,0,Todas,0,69396
2010-08-20,14,0,0,Todas,0,69410
2010-08-23,14,0,0,Todas,0,69424
2010-08-24,14,0,0,Todas,0,69438
2010-08-25,17,0,0,Todas,0,69455
2010-08-26,18,0,0,Todas,0,69473
2010-08-27,11,0,0,Todas,0,69484
2010-08-28,1,0,0,Todas,0,69485
2010-08-29,1,0,0,Todas,0,69486
2010-08-30,19,0,0,Todas,0,69505
2010-08-31,10,0,0,Todas,0,69515
2010-09-01,14,0,0,Todas,0,69529
2010-09-02,24,0,0,Todas,0,69553
2010-09-03,12,0,0,Todas,0,69565
2010-09-06,8,0,0,Todas,0,69573
2010-09-07,19,0,0,Todas,0,69592
2010-09-08,12,0,0,Todas,0,69604
2010-09-09,23,0,0,Todas,0,69627
2010-09-10,21,0,0,Todas,0,69648
2010-09-13,12,0,0,Todas,0,69660
2010-09-14,9,0,0,Todas,0,69669
2010-09-15,14,0,0,Todas,0,69683
2010-09-16,9,0,0,Todas,0,69692
2010-09-17,18,0,0,Todas,0,69710
2010-09-20,14,0,0,Todas,0,69724
2010-09-21,7,0,0,Todas,0,69731
2010-09-22,10,0,0,Todas,0,69741
2010-09-23,10,0,0,Todas,0,69751
2010-09-24,15,0,0,Todas,0,69766
2010-09-27,18,0,0,Todas,0,69784
2010-09-28,10,0,0,Todas,0,69794
2010-09-29,19,0,0,Todas,0,69813
2010-09-30,7,0,0,Todas,0,69820
2010-10-01,15,0,0,Todas,0,69835
2010-10-04,12,0,0,Todas,0,69847
2010-10-05,16,0,0,Todas,0,69863
2010-10-06,12,0,0,Todas,0,69875
2010-10-07,12,0,0,Todas,0,69887
2010-10-08,17,0,0,Todas,0,69904
2010-10-11,16,0,0,Todas,0,69920
2010-10-12,20,0,0,Todas,0,69940
2010-10-13,16,0,0,Todas,0,69956
2010-10-14,12,0,0,Todas,0,69968
2010-10-15,19,0,0,Todas,0,69987
2010-10-18,13,0,0,Todas,0,70000
2010-10-19,22,0,0,Todas,0,70022
2010-10-20,24,0,0,Todas,0,70046
2010-10-21,20,0,0,Todas,0,70066
2010-10-22,17,0,0,Todas,0,70083
2010-10-24,2,0,0,Todas,0,70085
2010-10-25,11,0,0,Todas,0,70096
2010-10-26,15,0,0,Todas,0,70111
2010-10-27,16,0,0,Todas,0,70127
2010-10-28,21,0,0,Todas,0,70148
2010-10-29,21,0,0,Todas,0,70169
2010-10-30,1,0,0,Todas,0,70170
2010-11-04,13,0,0,Todas,0,70183
2010-11-05,21,0,0,Todas,0,70204
2010-11-08,9,0,0,Todas,0,70213
2010-11-09,23,0,0,Todas,0,70236
2010-11-10,19,0,0,Todas,0,70255
2010-11-11,10,0,0,Todas,0,70265
2010-11-12,14,0,0,Todas,0,70279
2010-11-15,17,0,0,Todas,0,70296
2010-11-16,10,0,0,Todas,0,70306
2010-11-17,15,0,0,Todas,0,70321
2010-11-18,16,0,0,Todas,0,70337
2010-11-19,10,0,0,Todas,0,70347
2010-11-20,1,0,0,Todas,0,70348
2010-11-22,29,0,0,Todas,0,70377
2010-11-23,18,0,0,Todas,0,70395
2010-11-24,18,0,0,Todas,0,70413
2010-11-25,16,0,0,Todas,0,70429
2010-11-26,7,0,0,Todas,0,70436
2010-11-27,1,0,0,Todas,0,70437
2010-11-29,17,0,0,Todas,0,70454
2010-11-30,14,0,0,Todas,0,70468
2010-12-01,14,0,0,Todas,0,70482
2010-12-02,11,0,0,Todas,0,70493
2010-12-03,5,0,0,Todas,0,70498
2010-12-07,12,0,0,Todas,0,70510
2010-12-08,21,0,0,Todas,0,70531
2010-12-09,15,0,0,Todas,0,70546
2010-12-10,19,0,0,Todas,0,70565
2010-12-12,1,0,0,Todas,0,70566
2010-12-13,7,0,0,Todas,0,70573
2010-12-14,11,0,0,Todas,0,70584
2010-12-15,22,0,0,Todas,0,70606
2010-12-16,19,0,0,Todas,0,70625
2010-12-17,12,0,0,Todas,0,70637
2010-12-20,17,0,0,Todas,0,70654
2010-12-21,17,0,0,Todas,0,70671
2010-12-22,8,0,0,Todas,0,70679
2010-12-23,15,0,0,Todas,0,70694
2010-12-24,8,0,0,Todas,0,70702
2010-12-27,4,0,0,Todas,0,70706
2010-12-28,8,0,0,Todas,0,70714
2010-12-29,8,0,0,Todas,0,70722
2010-12-30,4,0,0,Todas,0,70726
2011-01-02,1,0,0,Todas,0,70727
2011-01-03,8,0,0,Todas,0,70735
2011-01-04,12,0,0,Todas,0,70747
2011-01-05,11,0,0,Todas,0,70758
2011-01-06,6,0,0,Todas,0,70764
2011-01-07,11,0,0,Todas,0,70775
2011-01-08,1,0,0,Todas,0,70776
2011-01-10,13,0,0,Todas,0,70789
2011-01-11,18,0,0,Todas,0,70807
2011-01-12,17,0,0,Todas,0,70824
2011-01-13,14,0,0,Todas,0,70838
2011-01-14,15,0,0,Todas,0,70853
2011-01-15,1,0,0,Todas,0,70854
2011-01-17,9,0,0,Todas,0,70863
2011-01-18,12,0,0,Todas,0,70875
2011-01-19,4,0,0,Todas,0,70879
2011-01-20,15,0,0,Todas,0,70894
2011-01-21,9,0,0,Todas,0,70903
2011-01-22,1,0,0,Todas,0,70904
2011-01-24,10,0,0,Todas,0,70914
2011-01-25,17,0,0,Todas,0,70931
2011-01-26,6,0,0,Todas,0,70937
2011-01-27,8,0,0,Todas,0,70945
2011-01-28,12,0,0,Todas,0,70957
2011-01-31,14,0,0,Todas,0,70971
2011-02-01,15,0,0,Todas,0,70986
2011-02-02,17,0,0,Todas,0,71003
2011-02-03,12,0,0,Todas,0,71015
2011-02-04,17,0,0,Todas,0,71032
2011-02-07,11,0,0,Todas,0,71043
2011-02-08,18,0,0,Todas,0,71061
2011-02-09,17,0,0,Todas,0,71078
2011-02-10,11,0,0,Todas,0,71089
2011-02-11,13,0,0,Todas,0,71102
2011-02-12,1,0,0,Todas,0,71103
2011-02-13,1,0,0,Todas,0,71104
2011-02-14,10,0,0,Todas,0,71114
2011-02-15,14,0,0,Todas,0,71128
2011-02-16,8,0,0,Todas,0,71136
2011-02-17,14,0,0,Todas,0,71150
2011-02-18,13,0,0,Todas,0,71163
2011-02-21,19,0,0,Todas,0,71182
2011-02-22,20,0,0,Todas,0,71202
2011-02-23,12,0,0,Todas,0,71214
2011-02-24,21,0,0,Todas,0,71235
2011-02-25,11,0,0,Todas,0,71246
2011-02-28,12,0,0,Todas,0,71258
2011-03-01,13,0,0,Todas,0,71271
2011-03-02,15,0,0,Todas,0,71286
2011-03-03,9,0,0,Todas,0,71295
2011-03-04,11,0,0,Todas,0,71306
2011-03-07,1,0,0,Todas,0,71307
2011-03-09,14,0,0,Todas,0,71321
2011-03-10,19,0,0,Todas,0,71340
2011-03-11,17,0,0,Todas,0,71357
2011-03-12,2,0,0,Todas,0,71359
2011-03-13,1,0,0,Todas,0,71360
2011-03-14,20,0,0,Todas,0,71380
2011-03-15,40,0,0,Todas,0,71420
2011-03-16,22,0,0,Todas,0,71442
2011-03-17,18,0,0,Todas,0,71460
2011-03-18,32,0,0,Todas,0,71492
2011-03-19,1,0,0,Todas,0,71493
2011-03-21,8,0,0,Todas,0,71501
2011-03-22,16,0,0,Todas,0,71517
2011-03-23,21,0,0,Todas,0,71538
2011-03-24,15,0,0,Todas,0,71553
2011-03-25,15,0,0,Todas,0,71568
2011-03-28,18,0,0,Todas,0,71586
2011-03-29,20,0,0,Todas,0,71606
2011-03-30,22,0,0,Todas,0,71628
2011-03-31,15,0,0,Todas,0,71643
2011-04-01,24,0,0,Todas,0,71667
2011-04-02,2,0,0,Todas,0,71669
2011-04-03,1,0,0,Todas,0,71670
2011-04-04,10,0,0,Todas,0,71680
2011-04-05,14,0,0,Todas,0,71694
2011-04-06,23,0,0,Todas,0,71717
2011-04-07,17,0,0,Todas,0,71734
2011-04-08,13,0,0,Todas,0,71747
2011-04-11,18,0,0,Todas,0,71765
2011-04-12,18,0,0,Todas,0,71783
2011-04-13,13,0,0,Todas,0,71796
2011-04-14,18,0,0,Todas,0,71814
2011-04-15,14,0,0,Todas,0,71828
2011-04-18,23,0,0,Todas,0,71851
2011-04-19,11,0,0,Todas,0,71862
2011-04-20,13,0,0,Todas,0,71875
2011-04-21,12,0,0,Todas,0,71887
2011-04-23,1,0,0,Todas,0,71888
2011-04-24,1,0,0,Todas,0,71889
2011-04-25,15,0,0,Todas,0,71904
2011-04-26,16,0,0,Todas,0,71920
2011-04-27,15,0,0,Todas,0,71935
2011-04-28,7,0,0,Todas,0,71942
2011-04-29,18,0,0,Todas,0,71960
2011-05-02,14,0,0,Todas,0,71974
2011-05-03,16,0,0,Todas,0,71990
2011-05-04,10,0,0,Todas,0,72000
2011-05-05,13,0,0,Todas,0,72013
2011-05-06,10,0,0,Todas,0,72023
2011-05-09,11,0,0,Todas,0,72034
2011-05-10,18,0,0,Todas,0,72052
2011-05-11,14,0,0,Todas,0,72066
2011-05-12,15,0,0,Todas,0,72081
2011-05-13,10,0,0,Todas,0,72091
2011-05-14,1,0,0,Todas,0,72092
2011-05-16,16,0,0,Todas,0,72108
2011-05-17,18,0,0,Todas,0,72126
2011-05-18,11,0,0,Todas,0,72137
2011-05-19,22,0,0,Todas,0,72159
2011-05-20,14,0,0,Todas,0,72173
2011-05-21,1,0,0,Todas,0,72174
2011-05-23,24,0,0,Todas,0,72198
2011-05-24,15,0,0,Todas,0,72213
2011-05-25,17,0,0,Todas,0,72230
2011-05-26,14,0,0,Todas,0,72244
2011-05-28,1,0,0,Todas,0,72245
2011-05-30,19,0,0,Todas,0,72264
2011-05-31,14,0,0,Todas,0,72278
2011-06-01,14,0,0,Todas,0,72292
2011-06-02,17,0,0,Todas,0,72309
2011-06-03,19,0,0,Todas,0,72328
2011-06-05,1,0,0,Todas,0,72329
2011-06-06,16,0,0,Todas,0,72345
2011-06-07,7,0,0,Todas,0,72352
2011-06-08,14,0,0,Todas,0,72366
2011-06-09,18,0,0,Todas,0,72384
2011-06-10,16,0,0,Todas,0,72400
2011-06-13,17,0,0,Todas,0,72417
2011-06-14,8,0,0,Todas,0,72425
2011-06-15,7,0,0,Todas,0,72432
2011-06-16,16,0,0,Todas,0,72448
2011-06-17,11,0,0,Todas,0,72459
2011-06-19,1,0,0,Todas,0,72460
2011-06-20,11,0,0,Todas,0,72471
2011-06-21,22,0,0,Todas,0,72493
2011-06-22,22,0,0,Todas,0,72515
2011-06-23,11,0,0,Todas,0,72526
2011-06-24,16,0,0,Todas,0,72542
2011-06-27,14,0,0,Todas,0,72556
2011-06-28,28,0,0,Todas,0,72584
2011-06-29,17,0,0,Todas,0,72601
2011-06-30,23,0,0,Todas,0,72624
2011-07-01,30,0,0,Todas,0,72654
2011-07-04,17,0,0,Todas,0,72671
2011-07-05,12,0,0,Todas,0,72683
2011-07-06,19,0,0,Todas,0,72702
2011-07-07,13,0,0,Todas,0,72715
2011-07-08,15,0,0,Todas,0,72730
2011-07-11,13,0,0,Todas,0,72743
2011-07-12,19,0,0,Todas,0,72762
2011-07-13,16,0,0,Todas,0,72778
2011-07-14,16,0,0,Todas,0,72794
2011-07-15,14,0,0,Todas,0,72808
2011-07-18,6,0,0,Todas,0,72814
2011-07-19,14,0,0,Todas,0,72828
2011-07-20,16,0,0,Todas,0,72844
2011-07-21,18,0,0,Todas,0,72862
2011-07-22,14,0,0,Todas,0,72876
2011-07-25,16,0,0,Todas,0,72892
2011-07-26,17,0,0,Todas,0,72909
2011-07-27,20,0,0,Todas,0,72929
2011-07-28,17,0,0,Todas,0,72946
2011-07-29,14,0,0,Todas,0,72960
2011-08-01,14,0,0,Todas,0,72974
2011-08-02,19,0,0,Todas,0,72993
2011-08-03,22,0,0,Todas,0,73015
2011-08-04,9,0,0,Todas,0,73024
2011-08-05,18,0,0,Todas,0,73042
2011-08-08,13,0,0,Todas,0,73055
2011-08-09,12,0,0,Todas,0,73067
2011-08-10,15,0,0,Todas,0,73082
2011-08-11,12,0,0,Todas,0,73094
2011-08-15,14,0,0,Todas,0,73108
2011-08-16,10,0,0,Todas,0,73118
2011-08-17,12,0,0,Todas,0,73130
2011-08-18,14,0,0,Todas,0,73144
2011-08-19,14,0,0,Todas,0,73158
2011-08-20,1,0,0,Todas,0,73159
2011-08-22,7,0,0,Todas,0,73166
2011-08-23,17,0,0,Todas,0,73183
2011-08-24,22,0,0,Todas,0,73205
2011-08-25,8,0,0,Todas,0,73213
2011-08-26,14,0,0,Todas,0,73227
2011-08-28,1,0,0,Todas,0,73228
2011-08-29,11,0,0,Todas,0,73239
2011-08-30,10,0,0,Todas,0,73249
2011-08-31,21,0,0,Todas,0,73270
2011-09-01,15,0,0,Todas,0,73285
2011-09-02,7,0,0,Todas,0,73292
2011-09-05,17,0,0,Todas,0,73309
2011-09-06,16,0,0,Todas,0,73325
2011-09-07,15,0,0,Todas,0,73340
2011-09-08,14,0,0,Todas,0,73354
2011-09-09,11,0,0,Todas,0,73365
2011-09-10,1,0,0,Todas,0,73366
2011-09-12,14,0,0,Todas,0,73380
2011-09-13,17,0,0,Todas,0,73397
2011-09-14,11,0,0,Todas,0,73408
2011-09-15,19,0,0,Todas,0,73427
2011-09-16,9,0,0,Todas,0,73436
2011-09-19,11,0,0,Todas,0,73447
2011-09-20,15,0,0,Todas,0,73462
2011-09-21,16,0,0,Todas,0,73478
2011-09-22,10,0,0,Todas,0,73488
2011-09-23,15,0,0,Todas,0,73503
2011-09-24,1,0,0,Todas,0,73504
2011-09-26,9,0,0,Todas,0,73513
2011-09-27,16,0,0,Todas,0,73529
2011-09-28,18,0,0,Todas,0,73547
2011-09-29,9,0,0,Todas,0,73556
2011-09-30,10,0,0,Todas,0,73566
2011-10-03,13,0,0,Todas,0,73579
2011-10-04,13,0,0,Todas,0,73592
2011-10-05,24,0,0,Todas,0,73616
2011-10-06,11,0,0,Todas,0,73627
2011-10-07,11,0,0,Todas,0,73638
2011-10-10,21,0,0,Todas,0,73659
2011-10-11,12,0,0,Todas,0,73671
2011-10-12,16,0,0,Todas,0,73687
2011-10-13,16,0,0,Todas,0,73703
2011-10-14,16,0,0,Todas,0,73719
2011-10-15,1,0,0,Todas,0,73720
2011-10-17,19,0,0,Todas,0,73739
2011-10-18,10,0,0,Todas,0,73749
2011-10-19,16,0,0,Todas,0,73765
2011-10-20,16,0,0,Todas,0,73781
2011-10-21,16,0,0,Todas,0,73797
2011-10-24,17,0,0,Todas,0,73814
2011-10-25,9,0,0,Todas,0,73823
2011-10-26,18,0,0,Todas,0,73841
2011-10-27,13,0,0,Todas,0,73854
2011-10-28,20,0,0,Todas,0,73874
2011-10-31,9,0,0,Todas,0,73883
2011-11-01,13,0,0,Todas,0,73896
2011-11-03,1,0,0,Todas,0,73897
2011-11-07,13,0,0,Todas,0,73910
2011-11-08,19,0,0,Todas,0,73929
2011-11-09,13,0,0,Todas,0,73942
2011-11-10,15,0,0,Todas,0,73957
2011-11-11,16,0,0,Todas,0,73973
2011-11-12,2,0,0,Todas,0,73975
2011-11-14,8,0,0,Todas,0,73983
2011-11-15,12,0,0,Todas,0,73995
2011-11-16,18,0,0,Todas,0,74013
2011-11-17,13,0,0,Todas,0,74026
2011-11-18,18,0,0,Todas,0,74044
2011-11-21,16,0,0,Todas,0,74060
2011-11-22,13,0,0,Todas,0,74073
2011-11-23,16,0,0,Todas,0,74089
2011-11-24,13,0,0,Todas,0,74102
2011-11-25,12,0,0,Todas,0,74114
2011-11-26,1,0,0,Todas,0,74115
2011-11-28,21,0,0,Todas,0,74136
2011-11-29,16,0,0,Todas,0,74152
2011-11-30,19,0,0,Todas,0,74171
2011-12-01,8,0,0,Todas,0,74179
2011-12-02,3,0,0,Todas,0,74182
2011-12-05,7,0,0,Todas,0,74189
2011-12-07,15,0,0,Todas,0,74204
2011-12-08,11,0,0,Todas,0,74215
2011-12-09,16,0,0,Todas,0,74231
2011-12-12,12,0,0,Todas,0,74243
2011-12-13,16,0,0,Todas,0,74259
2011-12-14,12,0,0,Todas,0,74271
2011-12-15,12,0,0,Todas,0,74283
2011-12-16,15,0,0,Todas,0,74298
2011-12-19,19,0,0,Todas,0,74317
2011-12-20,8,0,0,Todas,0,74325
2011-12-21,15,0,0,Todas,0,74340
2011-12-22,8,0,0,Todas,0,74348
2011-12-23,13,0,0,Todas,0,74361
2011-12-26,6,0,0,Todas,0,74367
2011-12-27,8,0,0,Todas,0,74375
2011-12-28,10,0,0,Todas,0,74385
2011-12-29,6,0,0,Todas,0,74391
2011-12-30,2,0,0,Todas,0,74393
2012-01-01,2,0,0,Todas,0,74395
2012-01-02,3,0,0,Todas,0,74398
2012-01-03,5,0,0,Todas,0,74403
2012-01-04,6,0,0,Todas,0,74409
2012-01-05,4,0,0,Todas,0,74413
2012-01-06,7,0,0,Todas,0,74420
2012-01-07,3,0,0,Todas,0,74423
2012-01-09,4,0,0,Todas,0,74427
2012-01-10,5,0,0,Todas,0,74432
2012-01-11,4,0,0,Todas,0,74436
2012-01-12,4,0,0,Todas,0,74440
2012-01-13,6,0,0,Todas,0,74446
2012-01-14,1,0,0,Todas,0,74447
2012-01-15,1,0,0,Todas,0,74448
2012-01-16,3,0,0,Todas,0,74451
2012-01-17,9,0,0,Todas,0,74460
2012-01-18,8,0,0,Todas,0,74468
2012-01-19,11,0,0,Todas,0,74479
2012-01-20,11,0,0,Todas,0,74490
2012-01-23,9,0,0,Todas,0,74499
2012-01-24,6,0,0,Todas,0,74505
2012-01-25,9,0,0,Todas,0,74514
2012-01-26,12,0,0,Todas,0,74526
2012-01-27,15,0,0,Todas,0,74541
2012-01-30,8,0,0,Todas,0,74549
2012-01-31,12,0,0,Todas,0,74561
2012-02-01,7,0,0,Todas,0,74568
2012-02-02,14,0,0,Todas,0,74582
2012-02-03,12,0,0,Todas,0,74594
2012-02-06,9,0,0,Todas,0,74603
2012-02-07,8,0,0,Todas,0,74611
2012-02-08,11,0,0,Todas,0,74622
2012-02-09,7,0,0,Todas,0,74629
2012-02-10,7,0,0,Todas,0,74636
2012-02-13,5,0,0,Todas,0,74641
2012-02-14,5,0,0,Todas,0,74646
2012-02-15,10,0,0,Todas,0,74656
2012-02-16,9,0,0,Todas,0,74665
2012-02-17,6,0,0,Todas,0,74671
2012-02-22,10,0,0,Todas,0,74681
2012-02-23,5,0,0,Todas,0,74686
2012-02-24,5,0,0,Todas,0,74691
2012-02-25,2,0,0,Todas,0,74693
2012-02-27,6,0,0,Todas,0,74699
2012-02-28,17,0,0,Todas,0,74716
2012-02-29,24,0,0,Todas,0,74740
2012-03-01,29,0,0,Todas,0,74769
2012-03-02,13,0,0,Todas,0,74782
2012-03-05,12,0,0,Todas,0,74794
2012-03-06,20,0,0,Todas,0,74814
2012-03-07,26,0,0,Todas,0,74840
2012-03-08,15,0,0,Todas,0,74855
2012-03-09,28,0,0,Todas,0,74883
2012-03-10,4,0,0,Todas,0,74887
2012-03-12,10,0,0,Todas,0,74897
2012-03-13,13,0,0,Todas,0,74910
2012-03-14,18,0,0,Todas,0,74928
2012-03-15,22,0,0,Todas,0,74950
2012-03-16,21,0,0,Todas,0,74971
2012-03-17,1,0,0,Todas,0,74972
2012-03-18,1,0,0,Todas,0,74973
2012-03-19,16,0,0,Todas,0,74989
2012-03-20,15,0,0,Todas,0,75004
2012-03-21,15,0,0,Todas,0,75019
2012-03-22,20,0,0,Todas,0,75039
2012-03-23,20,0,0,Todas,0,75059
2012-03-25,1,0,0,Todas,0,75060
2012-03-26,16,0,0,Todas,0,75076
2012-03-27,12,0,0,Todas,0,75088
2012-03-28,9,0,0,Todas,0,75097
2012-03-29,17,0,0,Todas,0,75114
2012-03-30,19,0,0,Todas,0,75133
2012-04-01,7,0,0,Todas,0,75140
2012-04-02,21,0,0,Todas,0,75161
2012-04-03,21,0,0,Todas,0,75182
2012-04-04,16,0,0,Todas,0,75198
2012-04-05,17,0,0,Todas,0,75215
2012-04-09,10,0,0,Todas,0,75225
2012-04-10,31,0,0,Todas,0,75256
2012-04-11,15,0,0,Todas,0,75271
2012-04-12,9,0,0,Todas,0,75280
2012-04-13,15,0,0,Todas,0,75295
2012-04-16,20,0,0,Todas,0,75315
2012-04-17,15,0,0,Todas,0,75330
2012-04-18,13,0,0,Todas,0,75343
2012-04-19,25,0,0,Todas,0,75368
2012-04-20,18,0,0,Todas,0,75386
2012-04-23,18,0,0,Todas,0,75404
2012-04-24,20,0,0,Todas,0,75424
2012-04-25,17,0,0,Todas,0,75441
2012-04-26,17,0,0,Todas,0,75458
2012-04-27,13,0,0,Todas,0,75471
2012-04-30,14,0,0,Todas,0,75485
2012-05-01,8,0,0,Todas,0,75493
2012-05-02,14,0,0,Todas,0,75507
2012-05-03,17,0,0,Todas,0,75524
2012-05-04,23,0,0,Todas,0,75547
2012-05-05,1,0,0,Todas,0,75548
2012-05-07,13,0,0,Todas,0,75561
2012-05-08,19,0,0,Todas,0,75580
2012-05-09,21,0,0,Todas,0,75601
2012-05-10,14,0,0,Todas,0,75615
2012-05-11,16,0,0,Todas,0,75631
2012-05-14,22,0,0,Todas,0,75653
2012-05-15,19,0,0,Todas,0,75672
2012-05-16,20,0,0,Todas,0,75692
2012-05-17,11,0,0,Todas,0,75703
2012-05-18,16,0,0,Todas,0,75719
2012-05-21,14,0,0,Todas,0,75733
2012-05-22,27,0,0,Todas,0,75760
2012-05-23,21,0,0,Todas,0,75781
2012-05-24,17,0,0,Todas,0,75798
2012-05-28,17,0,0,Todas,0,75815
2012-05-29,20,0,0,Todas,0,75835
2012-05-30,11,0,0,Todas,0,75846
2012-05-31,21,0,0,Todas,0,75867
2012-06-01,20,0,0,Todas,0,75887
2012-06-02,1,0,0,Todas,0,75888
2012-06-04,17,0,0,Todas,0,75905
2012-06-05,14,0,0,Todas,0,75919
2012-06-06,13,0,0,Todas,0,75932
2012-06-07,30,0,0,Todas,0,75962
2012-06-08,15,0,0,Todas,0,75977
2012-06-09,1,0,0,Todas,0,75978
2012-06-11,19,0,0,Todas,0,75997
2012-06-12,15,0,0,Todas,0,76012
2012-06-13,8,0,0,Todas,0,76020
2012-06-14,15,0,0,Todas,0,76035
2012-06-15,8,0,0,Todas,0,76043
2012-06-18,20,0,0,Todas,0,76063
2012-06-19,24,0,0,Todas,0,76087
2012-06-20,9,0,0,Todas,0,76096
2012-06-21,17,0,0,Todas,0,76113
2012-06-22,6,0,0,Todas,0,76119
2012-06-24,1,0,0,Todas,0,76120
2012-06-25,19,0,0,Todas,0,76139
2012-06-26,16,0,0,Todas,0,76155
2012-06-27,19,0,0,Todas,0,76174
2012-06-28,17,0,0,Todas,0,76191
2012-06-29,13,0,0,Todas,0,76204
2012-07-01,1,0,0,Todas,0,76205
2012-07-02,22,0,0,Todas,0,76227
2012-07-03,18,0,0,Todas,0,76245
2012-07-04,14,0,0,Todas,0,76259
2012-07-05,19,0,0,Todas,0,76278
2012-07-06,20,0,0,Todas,0,76298
2012-07-07,1,0,0,Todas,0,76299
2012-07-09,16,0,0,Todas,0,76315
2012-07-10,13,0,0,Todas,0,76328
2012-07-11,23,0,0,Todas,0,76351
2012-07-12,26,0,0,Todas,0,76377
2012-07-13,16,0,0,Todas,0,76393
2012-07-15,1,0,0,Todas,0,76394
2012-07-16,20,0,0,Todas,0,76414
2012-07-17,13,0,0,Todas,0,76427
2012-07-18,15,0,0,Todas,0,76442
2012-07-19,12,0,0,Todas,0,76454
2012-07-20,12,0,0,Todas,0,76466
2012-07-23,14,0,0,Todas,0,76480
2012-07-24,14,0,0,Todas,0,76494
2012-07-25,15,0,0,Todas,0,76509
2012-07-26,13,0,0,Todas,0,76522
2012-07-27,9,0,0,Todas,0,76531
2012-07-30,13,0,0,Todas,0,76544
2012-07-31,15,0,0,Todas,0,76559
2012-08-01,17,0,0,Todas,0,76576
2012-08-02,22,0,0,Todas,0,76598
2012-08-03,17,0,0,Todas,0,76615
2012-08-06,17,0,0,Todas,0,76632
2012-08-07,12,0,0,Todas,0,76644
2012-08-08,15,0,0,Todas,0,76659
2012-08-09,13,0,0,Todas,0,76672
2012-08-13,18,0,0,Todas,0,76690
2012-08-14,17,0,0,Todas,0,76707
2012-08-15,14,0,0,Todas,0,76721
2012-08-16,13,0,0,Todas,0,76734
2012-08-17,13,0,0,Todas,0,76747
2012-08-20,13,0,0,Todas,0,76760
2012-08-21,13,0,0,Todas,0,76773
2012-08-22,12,0,0,Todas,0,76785
2012-08-23,15,0,0,Todas,0,76800
2012-08-24,19,0,0,Todas,0,76819
2012-08-27,10,0,0,Todas,0,76829
2012-08-28,14,0,0,Todas,0,76843
2012-08-29,18,0,0,Todas,0,76861
2012-08-30,11,0,0,Todas,0,76872
2012-08-31,14,0,0,Todas,0,76886
2012-09-01,4,0,0,Todas,0,76890
2012-09-03,18,0,0,Todas,0,76908
2012-09-04,13,0,0,Todas,0,76921
2012-09-05,11,0,0,Todas,0,76932
2012-09-06,13,0,0,Todas,0,76945
2012-09-07,8,0,0,Todas,0,76953
2012-09-09,2,0,0,Todas,0,76955
2012-09-10,21,0,0,Todas,0,76976
2012-09-11,20,0,0,Todas,0,76996
2012-09-12,17,0,0,Todas,0,77013
2012-09-13,16,0,0,Todas,0,77029
2012-09-14,16,0,0,Todas,0,77045
2012-09-15,1,0,0,Todas,0,77046
2012-09-17,8,0,0,Todas,0,77054
2012-09-18,9,0,0,Todas,0,77063
2012-09-19,22,0,0,Todas,0,77085
2012-09-20,17,0,0,Todas,0,77102
2012-09-21,13,0,0,Todas,0,77115
2012-09-24,20,0,0,Todas,0,77135
2012-09-25,21,0,0,Todas,0,77156
2012-09-26,13,0,0,Todas,0,77169
2012-09-27,10,0,0,Todas,0,77179
2012-09-28,18,0,0,Todas,0,77197
2012-09-29,2,0,0,Todas,0,77199
2012-10-01,22,0,0,Todas,0,77221
2012-10-02,9,0,0,Todas,0,77230
2012-10-03,18,0,0,Todas,0,77248
2012-10-04,14,0,0,Todas,0,77262
2012-10-05,13,0,0,Todas,0,77275
2012-10-08,14,0,0,Todas,0,77289
2012-10-09,24,0,0,Todas,0,77313
2012-10-10,20,0,0,Todas,0,77333
2012-10-11,24,0,0,Todas,0,77357
2012-10-15,17,0,0,Todas,0,77374
2012-10-16,14,0,0,Todas,0,77388
2012-10-17,21,0,0,Todas,0,77409
2012-10-18,20,0,0,Todas,0,77429
2012-10-19,24,0,0,Todas,0,77453
2012-10-21,1,0,0,Todas,0,77454
2012-10-22,16,0,0,Todas,0,77470
2012-10-23,13,0,0,Todas,0,77483
2012-10-24,24,0,0,Todas,0,77507
2012-10-25,22,0,0,Todas,0,77529
2012-10-26,14,0,0,Todas,0,77543
2012-10-28,1,0,0,Todas,0,77544
2012-10-29,27,0,0,Todas,0,77571
2012-10-30,14,0,0,Todas,0,77585
2012-10-31,16,0,0,Todas,0,77601
2012-11-01,22,0,0,Todas,0,77623
2012-11-05,10,0,0,Todas,0,77633
2012-11-06,10,0,0,Todas,0,77643
2012-11-07,15,0,0,Todas,0,77658
2012-11-08,14,0,0,Todas,0,77672
2012-11-09,14,0,0,Todas,0,77686
2012-11-12,16,0,0,Todas,0,77702
2012-11-13,21,0,0,Todas,0,77723
2012-11-14,19,0,0,Todas,0,77742
2012-11-15,19,0,0,Todas,0,77761
2012-11-16,23,0,0,Todas,0,77784
2012-11-18,1,0,0,Todas,0,77785
2012-11-19,13,0,0,Todas,0,77798
2012-11-20,13,0,0,Todas,0,77811
2012-11-21,17,0,0,Todas,0,77828
2012-11-22,21,0,0,Todas,0,77849
2012-11-23,14,0,0,Todas,0,77863
2012-11-25,1,0,0,Todas,0,77864
2012-11-26,14,0,0,Todas,0,77878
2012-11-27,14,0,0,Todas,0,77892
2012-11-28,17,0,0,Todas,0,77909
2012-11-29,19,0,0,Todas,0,77928
2012-11-30,11,0,0,Todas,0,77939
2012-12-01,4,0,0,Todas,0,77943
2012-12-02,1,0,0,Todas,0,77944
2012-12-03,17,0,0,Todas,0,77961
2012-12-04,12,0,0,Todas,0,77973
2012-12-05,17,0,0,Todas,0,77990
2012-12-06,1,0,0,Todas,0,77991
2012-12-07,13,0,0,Todas,0,78004
2012-12-10,16,0,0,Todas,0,78020
2012-12-11,13,0,0,Todas,0,78033
2012-12-12,16,0,0,Todas,0,78049
2012-12-13,10,0,0,Todas,0,78059
2012-12-14,11,0,0,Todas,0,78070
2012-12-17,19,0,0,Todas,0,78089
2012-12-18,14,0,0,Todas,0,78103
2012-12-19,12,0,0,Todas,0,78115
2012-12-20,13,0,0,Todas,0,78128
2012-12-21,9,0,0,Todas,0,78137
2012-12-26,6,0,0,Todas,0,78143
2012-12-27,14,0,0,Todas,0,78157
2012-12-28,23,0,0,Todas,0,78180
2013-01-01,3,0,0,Todas,0,78183
2013-01-02,13,0,0,Todas,0,78196
2013-01-03,8,0,0,Todas,0,78204
2013-01-04,22,0,0,Todas,0,78226
2013-01-05,7,0,0,Todas,0,78233
2013-01-07,12,0,0,Todas,0,78245
2013-01-08,35,0,0,Todas,0,78280
2013-01-09,22,0,0,Todas,0,78302
2013-01-10,18,0,0,Todas,0,78320
2013-01-11,10,0,0,Todas,0,78330
2013-01-12,5,0,0,Todas,0,78335
2013-01-14,14,0,0,Todas,0,78349
2013-01-15,11,0,0,Todas,0,78360
2013-01-16,18,0,0,Todas,0,78378
2013-01-17,25,0,0,Todas,0,78403
2013-01-18,19,0,0,Todas,0,78422
2013-01-19,1,0,0,Todas,0,78423
2013-01-21,22,0,0,Todas,0,78445
2013-01-22,17,0,0,Todas,0,78462
2013-01-23,18,0,0,Todas,0,78480
2013-01-24,17,0,0,Todas,0,78497
2013-01-25,21,0,0,Todas,0,78518
2013-01-28,14,0,0,Todas,0,78532
2013-01-29,12,0,0,Todas,0,78544
2013-01-30,22,0,0,Todas,0,78566
2013-01-31,24,0,0,Todas,0,78590
2013-02-01,19,0,0,Todas,0,78609
2013-02-04,13,0,0,Todas,0,78622
2013-02-05,18,0,0,Todas,0,78640
2013-02-06,21,0,0,Todas,0,78661
2013-02-07,22,0,0,Todas,0,78683
2013-02-08,27,0,0,Todas,0,78710
2013-02-12,1,0,0,Todas,0,78711
2013-02-13,25,0,0,Todas,0,78736
2013-02-14,19,0,0,Todas,0,78755
2013-02-15,18,0,0,Todas,0,78773
2013-02-18,10,0,0,Todas,0,78783
2013-02-19,16,0,0,Todas,0,78799
2013-02-20,17,0,0,Todas,0,78816
2013-02-21,16,0,0,Todas,0,78832
2013-02-22,14,0,0,Todas,0,78846
2013-02-23,3,0,0,Todas,0,78849
2013-02-25,6,0,0,Todas,0,78855
2013-02-26,9,0,0,Todas,0,78864
2013-02-27,16,0,0,Todas,0,78880
2013-02-28,12,0,0,Todas,0,78892
2013-03-01,26,0,0,Todas,0,78918
2013-03-03,1,0,0,Todas,0,78919
2013-03-04,16,0,0,Todas,0,78935
2013-03-05,12,0,0,Todas,0,78947
2013-03-06,17,0,0,Todas,0,78964
2013-03-07,14,0,0,Todas,0,78978
2013-03-08,14,0,0,Todas,0,78992
2013-03-10,1,0,0,Todas,0,78993
2013-03-11,17,0,0,Todas,0,79010
2013-03-12,16,0,0,Todas,0,79026
2013-03-13,13,0,0,Todas,0,79039
2013-03-14,22,0,0,Todas,0,79061
2013-03-15,18,0,0,Todas,0,79079
2013-03-16,2,0,0,Todas,0,79081
2013-03-18,12,0,0,Todas,0,79093
2013-03-19,16,0,0,Todas,0,79109
2013-03-20,21,0,0,Todas,0,79130
2013-03-21,18,0,0,Todas,0,79148
2013-03-22,20,0,0,Todas,0,79168
2013-03-25,5,0,0,Todas,0,79173
2013-03-26,15,0,0,Todas,0,79188
2013-03-27,15,0,0,Todas,0,79203
2013-03-28,18,0,0,Todas,0,79221
2013-03-29,1,0,0,Todas,0,79222
2013-04-01,18,0,0,Todas,0,79240
2013-04-02,17,0,0,Todas,0,79257
2013-04-03,14,0,0,Todas,0,79271
2013-04-04,23,0,0,Todas,0,79294
2013-04-05,23,0,0,Todas,0,79317
2013-04-07,1,0,0,Todas,0,79318
2013-04-08,12,0,0,Todas,0,79330
2013-04-09,20,0,0,Todas,0,79350
2013-04-10,18,0,0,Todas,0,79368
2013-04-11,20,0,0,Todas,0,79388
2013-04-12,16,0,0,Todas,0,79404
2013-04-13,1,0,0,Todas,0,79405
2013-04-15,14,0,0,Todas,0,79419
2013-04-16,19,0,0,Todas,0,79438
2013-04-17,13,0,0,Todas,0,79451
2013-04-18,16,0,0,Todas,0,79467
2013-04-19,22,0,0,Todas,0,79489
2013-04-22,9,0,0,Todas,0,79498
2013-04-23,6,0,0,Todas,0,79504
2013-04-24,14,0,0,Todas,0,79518
2013-04-25,21,0,0,Todas,0,79539
2013-04-26,19,0,0,Todas,0,79558
2013-04-29,10,0,0,Todas,0,79568
2013-04-30,17,0,0,Todas,0,79585
2013-05-01,4,0,0,Todas,0,79589
2013-05-02,21,0,0,Todas,0,79610
2013-05-03,13,0,0,Todas,0,79623
2013-05-06,11,0,0,Todas,0,79634
2013-05-07,14,0,0,Todas,0,79648
2013-05-08,17,0,0,Todas,0,79665
2013-05-09,29,0,0,Todas,0,79694
2013-05-10,21,0,0,Todas,0,79715
2013-05-13,17,0,0,Todas,0,79732
2013-05-14,20,0,0,Todas,0,79752
2013-05-15,23,0,0,Todas,0,79775
2013-05-16,12,0,0,Todas,0,79787
2013-05-17,12,0,0,Todas,0,79799
2013-05-20,8,0,0,Todas,0,79807
2013-05-21,12,0,0,Todas,0,79819
2013-05-22,10,0,0,Todas,0,79829
2013-05-23,18,0,0,Todas,0,79847
2013-05-25,1,0,0,Todas,0,79848
2013-05-27,10,0,0,Todas,0,79858
2013-05-28,14,0,0,Todas,0,79872
2013-05-29,10,0,0,Todas,0,79882
2013-05-30,17,0,0,Todas,0,79899
2013-05-31,16,0,0,Todas,0,79915
2013-06-01,3,0,0,Todas,0,79918
2013-06-03,14,0,0,Todas,0,79932
2013-06-04,18,0,0,Todas,0,79950
2013-06-05,11,0,0,Todas,0,79961
2013-06-06,14,0,0,Todas,0,79975
2013-06-07,18,0,0,Todas,0,79993
2013-06-10,12,0,0,Todas,0,80005
2013-06-11,18,0,0,Todas,0,80023
2013-06-12,14,0,0,Todas,0,80037
2013-06-13,17,0,0,Todas,0,80054
2013-06-14,19,0,0,Todas,0,80073
2013-06-16,1,0,0,Todas,0,80074
2013-06-17,17,0,0,Todas,0,80091
2013-06-18,11,0,0,Todas,0,80102
2013-06-19,14,0,0,Todas,0,80116
2013-06-20,18,0,0,Todas,0,80134
2013-06-21,13,0,0,Todas,0,80147
2013-06-24,7,0,0,Todas,0,80154
2013-06-25,34,0,0,Todas,0,80188
2013-06-26,21,0,0,Todas,0,80209
2013-06-27,23,0,0,Todas,0,80232
2013-06-28,19,0,0,Todas,0,80251
2013-07-01,23,0,0,Todas,0,80274
2013-07-02,18,0,0,Todas,0,80292
2013-07-03,33,0,0,Todas,0,80325
2013-07-04,21,0,0,Todas,0,80346
2013-07-05,28,0,0,Todas,0,80374
2013-07-08,11,0,0,Todas,0,80385
2013-07-09,16,0,0,Todas,0,80401
2013-07-10,13,0,0,Todas,0,80414
2013-07-11,16,0,0,Todas,0,80430
2013-07-12,26,0,0,Todas,0,80456
2013-07-15,18,0,0,Todas,0,80474
2013-07-16,21,0,0,Todas,0,80495
2013-07-17,20,0,0,Todas,0,80515
2013-07-18,15,0,0,Todas,0,80530
2013-07-19,21,0,0,Todas,0,80551
2013-07-22,15,0,0,Todas,0,80566
2013-07-23,18,0,0,Todas,0,80584
2013-07-24,24,0,0,Todas,0,80608
2013-07-25,21,0,0,Todas,0,80629
2013-07-26,15,0,0,Todas,0,80644
2013-07-29,17,0,0,Todas,0,80661
2013-07-30,16,0,0,Todas,0,80677
2013-07-31,16,0,0,Todas,0,80693
2013-08-01,19,0,0,Todas,0,80712
2013-08-02,22,0,0,Todas,0,80734
2013-08-05,16,0,0,Todas,0,80750
2013-08-06,10,0,0,Todas,0,80760
2013-08-07,19,0,0,Todas,0,80779
2013-08-08,17,0,0,Todas,0,80796
2013-08-09,15,0,0,Todas,0,80811
2013-08-11,1,0,0,Todas,0,80812
2013-08-12,15,0,0,Todas,0,80827
2013-08-13,16,0,0,Todas,0,80843
2013-08-14,14,0,0,Todas,0,80857
2013-08-15,17,0,0,Todas,0,80874
2013-08-16,17,0,0,Todas,0,80891
2013-08-19,15,0,0,Todas,0,80906
2013-08-20,14,0,0,Todas,0,80920
2013-08-21,19,0,0,Todas,0,80939
2013-08-22,23,0,0,Todas,0,80962
2013-08-23,12,0,0,Todas,0,80974
2013-08-26,16,0,0,Todas,0,80990
2013-08-27,15,0,0,Todas,0,81005
2013-08-28,25,0,0,Todas,0,81030
2013-08-29,20,0,0,Todas,0,81050
2013-08-30,16,0,0,Todas,0,81066
2013-09-01,2,0,0,Todas,0,81068
2013-09-02,8,0,0,Todas,0,81076
2013-09-03,15,0,0,Todas,0,81091
2013-09-04,13,0,0,Todas,0,81104
2013-09-05,15,0,0,Todas,0,81119
2013-09-06,13,0,0,Todas,0,81132
2013-09-09,12,0,0,Todas,0,81144
2013-09-10,6,0,0,Todas,0,81150
2013-09-11,17,0,0,Todas,0,81167
2013-09-12,10,0,0,Todas,0,81177
2013-09-13,16,0,0,Todas,0,81193
2013-09-15,1,0,0,Todas,0,81194
2013-09-16,20,0,0,Todas,0,81214
2013-09-17,15,0,0,Todas,0,81229
2013-09-18,14,0,0,Todas,0,81243
2013-09-19,24,0,0,Todas,0,81267
2013-09-20,29,0,0,Todas,0,81296
2013-09-23,14,0,0,Todas,0,81310
2013-09-24,16,0,0,Todas,0,81326
2013-09-25,13,0,0,Todas,0,81339
2013-09-26,19,0,0,Todas,0,81358
2013-09-27,15,0,0,Todas,0,81373
2013-09-30,14,0,0,Todas,0,81387
2013-10-01,17,0,0,Todas,0,81404
2013-10-02,17,0,0,Todas,0,81421
2013-10-03,13,0,0,Todas,0,81434
2013-10-04,14,0,0,Todas,0,81448
2013-10-07,13,0,0,Todas,0,81461
2013-10-08,25,0,0,Todas,0,81486
2013-10-09,18,0,0,Todas,0,81504
2013-10-10,14,0,0,Todas,0,81518
2013-10-14,16,0,0,Todas,0,81534
2013-10-15,12,0,0,Todas,0,81546
2013-10-16,23,0,0,Todas,0,81569
2013-10-17,12,0,0,Todas,0,81581
2013-10-18,19,0,0,Todas,0,81600
2013-10-21,14,0,0,Todas,0,81614
2013-10-22,16,0,0,Todas,0,81630
2013-10-23,16,0,0,Todas,0,81646
2013-10-24,11,0,0,Todas,0,81657
2013-10-25,25,0,0,Todas,0,81682
2013-10-28,8,0,0,Todas,0,81690
2013-10-29,16,0,0,Todas,0,81706
2013-10-30,17,0,0,Todas,0,81723
2013-10-31,16,0,0,Todas,0,81739
2013-11-01,23,0,0,Todas,0,81762
2013-11-04,13,0,0,Todas,0,81775
2013-11-05,21,0,0,Todas,0,81796
2013-11-06,17,0,0,Todas,0,81813
2013-11-07,17,0,0,Todas,0,81830
2013-11-08,19,0,0,Todas,0,81849
2013-11-11,16,0,0,Todas,0,81865
2013-11-12,17,0,0,Todas,0,81882
2013-11-13,20,0,0,Todas,0,81902
2013-11-14,14,0,0,Todas,0,81916
2013-11-15,19,0,0,Todas,0,81935
2013-11-18,42,0,0,Todas,0,81977
2013-11-19,22,0,0,Todas,0,81999
2013-11-20,23,0,0,Todas,0,82022
2013-11-21,17,0,0,Todas,0,82039
2013-11-22,16,0,0,Todas,0,82055
2013-11-25,16,0,0,Todas,0,82071
2013-11-26,12,0,0,Todas,0,82083
2013-11-27,13,0,0,Todas,0,82096
2013-11-28,17,0,0,Todas,0,82113
2013-11-29,16,0,0,Todas,0,82129
2013-12-01,5,0,0,Todas,0,82134
2013-12-02,21,0,0,Todas,0,82155
2013-12-03,12,0,0,Todas,0,82167
2013-12-04,18,0,0,Todas,0,82185
2013-12-05,13,0,0,Todas,0,82198
2013-12-06,3,0,0,Todas,0,82201
2013-12-09,13,0,0,Todas,0,82214
2013-12-10,14,0,0,Todas,0,82228
2013-12-11,28,0,0,Todas,0,82256
2013-12-12,20,0,0,Todas,0,82276
2013-12-13,16,0,0,Todas,0,82292
2013-12-14,1,0,0,Todas,0,82293
2013-12-16,10,0,0,Todas,0,82303
2013-12-17,9,0,0,Todas,0,82312
2013-12-18,22,0,0,Todas,0,82334
2013-12-19,23,0,0,Todas,0,82357
2013-12-20,16,0,0,Todas,0,82373
2013-12-23,14,0,0,Todas,0,82387
2013-12-24,16,0,0,Todas,0,82403
2013-12-26,8,0,0,Todas,0,82411
2013-12-27,20,0,0,Todas,0,82431
2014-01-01,2,0,0,Todas,0,82433
2014-01-02,3,0,0,Todas,0,82436
2014-01-03,34,0,0,Todas,0,82470
2014-01-06,31,0,0,Todas,0,82501
2014-01-07,34,0,0,Todas,0,82535
2014-01-08,15,0,0,Todas,0,82550
2014-01-09,17,0,0,Todas,0,82567
2014-01-10,22,0,0,Todas,0,82589
2014-01-13,14,0,0,Todas,0,82603
2014-01-14,17,0,0,Todas,0,82620
2014-01-15,15,0,0,Todas,0,82635
2014-01-16,22,0,0,Todas,0,82657
2014-01-17,15,0,0,Todas,0,82672
2014-01-20,12,0,0,Todas,0,82684
2014-01-21,17,0,0,Todas,0,82701
2014-01-22,16,0,0,Todas,0,82717
2014-01-23,23,0,0,Todas,0,82740
2014-01-24,20,0,0,Todas,0,82760
2014-01-26,1,0,0,Todas,0,82761
2014-01-27,12,0,0,Todas,0,82773
2014-01-28,9,0,0,Todas,0,82782
2014-01-29,21,0,0,Todas,0,82803
2014-01-30,9,0,0,Todas,0,82812
2014-01-31,9,0,0,Todas,0,82821
2014-02-01,2,0,0,Todas,0,82823
2014-02-03,12,0,0,Todas,0,82835
2014-02-04,15,0,0,Todas,0,82850
2014-02-05,11,0,0,Todas,0,82861
2014-02-06,16,0,0,Todas,0,82877
2014-02-07,15,0,0,Todas,0,82892
2014-02-10,12,0,0,Todas,0,82904
2014-02-11,14,0,0,Todas,0,82918
2014-02-12,9,0,0,Todas,0,82927
2014-02-13,17,0,0,Todas,0,82944
2014-02-14,29,0,0,Todas,0,82973
2014-02-15,1,0,0,Todas,0,82974
2014-02-17,16,0,0,Todas,0,82990
2014-02-18,14,0,0,Todas,0,83004
2014-02-19,14,0,0,Todas,0,83018
2014-02-20,16,0,0,Todas,0,83034
2014-02-21,25,0,0,Todas,0,83059
2014-02-24,12,0,0,Todas,0,83071
2014-02-25,11,0,0,Todas,0,83082
2014-02-26,25,0,0,Todas,0,83107
2014-02-27,13,0,0,Todas,0,83120
2014-02-28,17,0,0,Todas,0,83137
2014-03-01,1,0,0,Todas,0,83138
2014-03-05,12,0,0,Todas,0,83150
2014-03-06,11,0,0,Todas,0,83161
2014-03-07,20,0,0,Todas,0,83181
2014-03-08,9,0,0,Todas,0,83190
2014-03-10,7,0,0,Todas,0,83197
2014-03-11,24,0,0,Todas,0,83221
2014-03-12,14,0,0,Todas,0,83235
2014-03-13,13,0,0,Todas,0,83248
2014-03-14,12,0,0,Todas,0,83260
2014-03-15,4,0,0,Todas,0,83264
2014-03-17,10,0,0,Todas,0,83274
2014-03-18,12,0,0,Todas,0,83286
2014-03-19,9,0,0,Todas,0,83295
2014-03-20,16,0,0,Todas,0,83311
2014-03-21,19,0,0,Todas,0,83330
2014-03-24,12,0,0,Todas,0,83342
2014-03-25,17,0,0,Todas,0,83359
2014-03-26,27,0,0,Todas,0,83386
2014-03-27,15,0,0,Todas,0,83401
2014-03-28,17,0,0,Todas,0,83418
2014-03-31,12,0,0,Todas,0,83430
2014-04-01,17,0,0,Todas,0,83447
2014-04-02,21,0,0,Todas,0,83468
2014-04-03,12,0,0,Todas,0,83480
2014-04-04,11,0,0,Todas,0,83491
2014-04-07,14,0,0,Todas,0,83505
2014-04-08,20,0,0,Todas,0,83525
2014-04-09,12,0,0,Todas,0,83537
2014-04-10,17,0,0,Todas,0,83554
2014-04-11,18,0,0,Todas,0,83572
2014-04-14,14,0,0,Todas,0,83586
2014-04-15,18,0,0,Todas,0,83604
2014-04-16,20,0,0,Todas,0,83624
2014-04-17,13,0,0,Todas,0,83637
2014-04-21,7,0,0,Todas,0,83644
2014-04-22,12,0,0,Todas,0,83656
2014-04-23,11,0,0,Todas,0,83667
2014-04-24,15,0,0,Todas,0,83682
2014-04-25,15,0,0,Todas,0,83697
2014-04-28,13,0,0,Todas,0,83710
2014-04-29,17,0,0,Todas,0,83727
2014-04-30,10,0,0,Todas,0,83737
2014-05-01,5,0,0,Todas,0,83742
2014-05-02,20,0,0,Todas,0,83762
2014-05-04,1,0,0,Todas,0,83763
2014-05-05,13,0,0,Todas,0,83776
2014-05-06,12,0,0,Todas,0,83788
2014-05-07,12,0,0,Todas,0,83800
2014-05-08,14,0,0,Todas,0,83814
2014-05-09,12,0,0,Todas,0,83826
2014-05-12,8,0,0,Todas,0,83834
2014-05-13,13,0,0,Todas,0,83847
2014-05-14,10,0,0,Todas,0,83857
2014-05-15,13,0,0,Todas,0,83870
2014-05-16,18,0,0,Todas,0,83888
2014-05-19,14,0,0,Todas,0,83902
2014-05-20,27,0,0,Todas,0,83929
2014-05-21,12,0,0,Todas,0,83941
2014-05-22,12,0,0,Todas,0,83953
2014-05-23,12,0,0,Todas,0,83965
2014-05-25,1,0,0,Todas,0,83966
2014-05-26,13,0,0,Todas,0,83979
2014-05-27,19,0,0,Todas,0,83998
2014-05-28,11,0,0,Todas,0,84009
2014-05-29,21,0,0,Todas,0,84030
2014-05-30,13,0,0,Todas,0,84043
2014-06-02,19,0,0,Todas,0,84062
2014-06-03,10,0,0,Todas,0,84072
2014-06-04,21,0,0,Todas,0,84093
2014-06-05,19,0,0,Todas,0,84112
2014-06-06,16,0,0,Todas,0,84128
2014-06-09,15,0,0,Todas,0,84143
2014-06-10,15,0,0,Todas,0,84158
2014-06-11,17,0,0,Todas,0,84175
2014-06-12,20,0,0,Todas,0,84195
2014-06-13,12,0,0,Todas,0,84207
2014-06-15,1,0,0,Todas,0,84208
2014-06-16,16,0,0,Todas,0,84224
2014-06-17,9,0,0,Todas,0,84233
2014-06-18,9,0,0,Todas,0,84242
2014-06-19,14,0,0,Todas,0,84256
2014-06-20,14,0,0,Todas,0,84270
2014-06-21,1,0,0,Todas,0,84271
2014-06-23,13,0,0,Todas,0,84284
2014-06-24,22,0,0,Todas,0,84306
2014-06-25,13,0,0,Todas,0,84319
2014-06-26,12,0,0,Todas,0,84331
2014-06-27,15,0,0,Todas,0,84346
2014-06-30,11,0,0,Todas,0,84357
2014-07-01,18,0,0,Todas,0,84375
2014-07-02,18,0,0,Todas,0,84393
2014-07-03,17,0,0,Todas,0,84410
2014-07-04,27,0,0,Todas,0,84437
2014-07-07,11,0,0,Todas,0,84448
2014-07-08,24,0,0,Todas,0,84472
2014-07-09,10,0,0,Todas,0,84482
2014-07-10,18,0,0,Todas,0,84500
2014-07-11,11,0,0,Todas,0,84511
2014-07-14,17,0,0,Todas,0,84528
2014-07-15,23,0,0,Todas,0,84551
2014-07-16,18,0,0,Todas,0,84569
2014-07-17,20,0,0,Todas,0,84589
2014-07-18,12,0,0,Todas,0,84601
2014-07-21,15,0,0,Todas,0,84616
2014-07-22,15,0,0,Todas,0,84631
2014-07-23,19,0,0,Todas,0,84650
2014-07-24,21,0,0,Todas,0,84671
2014-07-25,13,0,0,Todas,0,84684
2014-07-28,11,0,0,Todas,0,84695
2014-07-29,20,0,0,Todas,0,84715
2014-07-30,17,0,0,Todas,0,84732
2014-07-31,19,0,0,Todas,0,84751
2014-08-01,23,0,0,Todas,0,84774
2014-08-04,13,0,0,Todas,0,84787
2014-08-05,23,0,0,Todas,0,84810
2014-08-06,19,0,0,Todas,0,84829
2014-08-07,19,0,0,Todas,0,84848
2014-08-08,20,0,0,Todas,0,84868
2014-08-11,15,0,0,Todas,0,84883
2014-08-12,20,0,0,Todas,0,84903
2014-08-13,20,0,0,Todas,0,84923
2014-08-14,16,0,0,Todas,0,84939
2014-08-15,14,0,0,Todas,0,84953
2014-08-16,1,0,0,Todas,0,84954
2014-08-18,13,0,0,Todas,0,84967
2014-08-19,13,0,0,Todas,0,84980
2014-08-20,23,0,0,Todas,0,85003
2014-08-21,12,0,0,Todas,0,85015
2014-08-22,14,0,0,Todas,0,85029
2014-08-24,1,0,0,Todas,0,85030
2014-08-25,8,0,0,Todas,0,85038
2014-08-26,21,0,0,Todas,0,85059
2014-08-27,14,0,0,Todas,0,85073
2014-08-28,22,0,0,Todas,0,85095
2014-08-29,17,0,0,Todas,0,85112
2014-08-30,2,0,0,Todas,0,85114
2014-09-01,20,0,0,Todas,0,85134
2014-09-02,18,0,0,Todas,0,85152
2014-09-03,18,0,0,Todas,0,85170
2014-09-04,25,0,0,Todas,0,85195
2014-09-05,19,0,0,Todas,0,85214
2014-09-08,11,0,0,Todas,0,85225
2014-09-09,26,0,0,Todas,0,85251
2014-09-10,22,0,0,Todas,0,85273
2014-09-11,18,0,0,Todas,0,85291
2014-09-12,18,0,0,Todas,0,85309
2014-09-15,14,0,0,Todas,0,85323
2014-09-16,27,0,0,Todas,0,85350
2014-09-17,21,0,0,Todas,0,85371
2014-09-18,18,0,0,Todas,0,85389
2014-09-19,17,0,0,Todas,0,85406
2014-09-22,12,0,0,Todas,0,85418
2014-09-23,22,0,0,Todas,0,85440
2014-09-24,26,0,0,Todas,0,85466
2014-09-25,27,0,0,Todas,0,85493
2014-09-26,23,0,0,Todas,0,85516
2014-09-29,11,0,0,Todas,0,85527
2014-09-30,18,0,0,Todas,0,85545
2014-10-01,23,0,0,Todas,0,85568
2014-10-02,20,0,0,Todas,0,85588
2014-10-03,17,0,0,Todas,0,85605
2014-10-06,25,0,0,Todas,0,85630
2014-10-07,23,0,0,Todas,0,85653
2014-10-08,29,0,0,Todas,0,85682
2014-10-09,34,0,0,Todas,0,85716
2014-10-13,14,0,0,Todas,0,85730
2014-10-14,23,0,0,Todas,0,85753
2014-10-15,25,0,0,Todas,0,85778
2014-10-16,28,0,0,Todas,0,85806
2014-10-17,24,0,0,Todas,0,85830
2014-10-20,21,0,0,Todas,0,85851
2014-10-21,29,0,0,Todas,0,85880
2014-10-22,28,0,0,Todas,0,85908
2014-10-23,28,0,0,Todas,0,85936
2014-10-24,21,0,0,Todas,0,85957
2014-10-26,1,0,0,Todas,0,85958
2014-10-27,19,0,0,Todas,0,85977
2014-10-28,19,0,0,Todas,0,85996
2014-10-29,27,0,0,Todas,0,86023
2014-10-30,26,0,0,Todas,0,86049
2014-10-31,22,0,0,Todas,0,86071
2014-11-01,1,0,0,Todas,0,86072
2014-11-04,25,0,0,Todas,0,86097
2014-11-05,20,0,0,Todas,0,86117
2014-11-06,21,0,0,Todas,0,86138
2014-11-07,23,0,0,Todas,0,86161
2014-11-09,1,0,0,Todas,0,86162
2014-11-10,23,0,0,Todas,0,86185
2014-11-11,38,0,0,Todas,0,86223
2014-11-12,23,0,0,Todas,0,86246
2014-11-13,30,0,0,Todas,0,86276
2014-11-14,31,0,0,Todas,0,86307
2014-11-17,22,0,0,Todas,0,86329
2014-11-18,26,0,0,Todas,0,86355
2014-11-19,19,0,0,Todas,0,86374
2014-11-20,28,0,0,Todas,0,86402
2014-11-21,24,0,0,Todas,0,86426
2014-11-24,21,0,0,Todas,0,86447
2014-11-25,31,0,0,Todas,0,86478
2014-11-26,19,0,0,Todas,0,86497
2014-11-27,32,0,0,Todas,0,86529
2014-11-28,22,0,0,Todas,0,86551
2014-11-30,1,0,0,Todas,0,86552
2014-12-01,7,0,0,Todas,0,86559
2014-12-02,29,0,0,Todas,0,86588
2014-12-03,37,0,0,Todas,0,86625
2014-12-04,24,0,0,Todas,0,86649
2014-12-05,19,0,0,Todas,0,86668
2014-12-08,25,0,0,Todas,0,86693
2014-12-09,34,0,0,Todas,0,86727
2014-12-10,30,0,0,Todas,0,86757
2014-12-11,26,0,0,Todas,0,86783
2014-12-12,23,0,0,Todas,0,86806
2014-12-14,1,0,0,Todas,0,86807
2014-12-15,23,0,0,Todas,0,86830
2014-12-16,20,0,0,Todas,0,86850
2014-12-17,27,0,0,Todas,0,86877
2014-12-18,27,0,0,Todas,0,86904
2014-12-19,19,0,0,Todas,0,86923
2014-12-20,14,0,0,Todas,0,86937
2014-12-22,16,0,0,Todas,0,86953
2014-12-23,13,0,0,Todas,0,86966
2014-12-24,7,0,0,Todas,0,86973
2014-12-29,18,0,0,Todas,0,86991
2014-12-30,12,0,0,Todas,0,87003
2014-12-31,5,0,0,Todas,0,87008
2015-01-01,3,0,0,Todas,0,87011
2015-01-05,14,0,0,Todas,0,87025
2015-01-06,14,0,0,Todas,0,87039
2015-01-07,25,0,0,Todas,0,87064
2015-01-08,15,0,0,Todas,0,87079
2015-01-09,22,0,0,Todas,0,87101
2015-01-10,26,0,0,Todas,0,87127
2015-01-12,16,0,0,Todas,0,87143
2015-01-13,18,0,0,Todas,0,87161
2015-01-14,11,0,0,Todas,0,87172
2015-01-15,16,0,0,Todas,0,87188
2015-01-16,12,0,0,Todas,0,87200
2015-01-18,1,0,0,Todas,0,87201
2015-01-19,34,0,0,Todas,0,87235
2015-01-20,24,0,0,Todas,0,87259
2015-01-21,24,0,0,Todas,0,87283
2015-01-22,25,0,0,Todas,0,87308
2015-01-23,19,0,0,Todas,0,87327
2015-01-26,14,0,0,Todas,0,87341
2015-01-27,13,0,0,Todas,0,87354
2015-01-28,28,0,0,Todas,0,87382
2015-01-29,17,0,0,Todas,0,87399
2015-01-30,32,0,0,Todas,0,87431
2015-02-01,2,0,0,Todas,0,87433
2015-02-02,24,0,0,Todas,0,87457
2015-02-03,22,0,0,Todas,0,87479
2015-02-04,27,0,0,Todas,0,87506
2015-02-05,27,0,0,Todas,0,87533
2015-02-06,24,0,0,Todas,0,87557
2015-02-09,25,0,0,Todas,0,87582
2015-02-10,21,0,0,Todas,0,87603
2015-02-11,14,0,0,Todas,0,87617
2015-02-12,19,0,0,Todas,0,87636
2015-02-13,19,0,0,Todas,0,87655
2015-02-18,16,0,0,Todas,0,87671
2015-02-19,27,0,0,Todas,0,87698
2015-02-20,15,0,0,Todas,0,87713
2015-02-21,23,0,0,Todas,0,87736
2015-02-23,21,0,0,Todas,0,87757
2015-02-24,15,0,0,Todas,0,87772
2015-02-25,20,0,0,Todas,0,87792
2015-02-26,29,0,0,Todas,0,87821
2015-02-27,28,0,0,Todas,0,87849
2015-02-28,12,0,0,Todas,0,87861
2015-03-01,1,0,0,Todas,0,87862
2015-03-02,30,0,0,Todas,0,87892
2015-03-03,24,0,0,Todas,0,87916
2015-03-04,23,0,0,Todas,0,87939
2015-03-05,15,0,0,Todas,0,87954
2015-03-06,21,0,0,Todas,0,87975
2015-03-09,16,0,0,Todas,0,87991
2015-03-10,17,0,0,Todas,0,88008
2015-03-11,13,0,0,Todas,0,88021
2015-03-12,31,0,0,Todas,0,88052
2015-03-13,18,0,0,Todas,0,88070
2015-03-16,26,0,0,Todas,0,88096
2015-03-17,16,0,0,Todas,0,88112
2015-03-18,17,0,0,Todas,0,88129
2015-03-19,22,0,0,Todas,0,88151
2015-03-20,22,0,0,Todas,0,88173
2015-03-23,13,0,0,Todas,0,88186
2015-03-24,27,0,0,Todas,0,88213
2015-03-25,19,0,0,Todas,0,88232
2015-03-26,21,0,0,Todas,0,88253
2015-03-27,19,0,0,Todas,0,88272
2015-03-30,22,0,0,Todas,0,88294
2015-03-31,26,0,0,Todas,0,88320
2015-04-01,21,0,0,Todas,0,88341
2015-04-02,25,0,0,Todas,0,88366
2015-04-06,17,0,0,Todas,0,88383
2015-04-07,23,0,0,Todas,0,88406
2015-04-08,16,0,0,Todas,0,88422
2015-04-09,11,0,0,Todas,0,88433
2015-04-10,13,0,0,Todas,0,88446
2015-04-13,21,0,0,Todas,0,88467
2015-04-14,37,0,0,Todas,0,88504
2015-04-15,22,0,0,Todas,0,88526
2015-04-16,20,0,0,Todas,0,88546
2015-04-17,24,0,0,Todas,0,88570
2015-04-20,23,0,0,Todas,0,88593
2015-04-21,10,0,0,Todas,0,88603
2015-04-22,22,0,0,Todas,0,88625
2015-04-23,21,0,0,Todas,0,88646
2015-04-24,16,0,0,Todas,0,88662
2015-04-25,1,0,0,Todas,0,88663
2015-04-27,18,0,0,Todas,0,88681
2015-04-28,22,0,0,Todas,0,88703
2015-04-29,25,0,0,Todas,0,88728
2015-04-30,19,0,0,Todas,0,88747
2015-05-01,1,0,0,Todas,0,88748
2015-05-04,25,0,0,Todas,0,88773
2015-05-05,29,0,0,Todas,0,88802
2015-05-06,26,0,0,Todas,0,88828
2015-05-07,26,0,0,Todas,0,88854
2015-05-08,24,0,0,Todas,0,88878
2015-05-10,1,0,0,Todas,0,88879
2015-05-11,24,0,0,Todas,0,88903
2015-05-12,22,0,0,Todas,0,88925
2015-05-13,17,0,0,Todas,0,88942
2015-05-14,26,0,0,Todas,0,88968
2015-05-15,22,0,0,Todas,0,88990
2015-05-16,1,0,0,Todas,0,88991
2015-05-18,23,0,0,Todas,0,89014
2015-05-19,23,0,0,Todas,0,89037
2015-05-20,26,0,0,Todas,0,89063
2015-05-21,21,0,0,Todas,0,89084
2015-05-22,16,0,0,Todas,0,89100
2015-05-24,1,0,0,Todas,0,89101
2015-05-25,30,0,0,Todas,0,89131
2015-05-26,15,0,0,Todas,0,89146
2015-05-27,17,0,0,Todas,0,89163
2015-05-28,20,0,0,Todas,0,89183
2015-05-29,11,0,0,Todas,0,89194
2015-06-01,16,0,0,Todas,0,89210
2015-06-02,23,0,0,Todas,0,89233
2015-06-03,23,0,0,Todas,0,89256
2015-06-04,17,0,0,Todas,0,89273
2015-06-05,9,0,0,Todas,0,89282
2015-06-06,1,0,0,Todas,0,89283
2015-06-08,20,0,0,Todas,0,89303
2015-06-09,21,0,0,Todas,0,89324
2015-06-10,21,0,0,Todas,0,89345
2015-06-11,27,0,0,Todas,0,89372
2015-06-12,26,0,0,Todas,0,89398
2015-06-15,20,0,0,Todas,0,89418
2015-06-16,23,0,0,Todas,0,89441
2015-06-17,24,0,0,Todas,0,89465
2015-06-18,22,0,0,Todas,0,89487
2015-06-19,23,0,0,Todas,0,89510
2015-06-22,16,0,0,Todas,0,89526
2015-06-23,25,0,0,Todas,0,89551
2015-06-24,24,0,0,Todas,0,89575
2015-06-25,20,0,0,Todas,0,89595
2015-06-26,26,0,0,Todas,0,89621
2015-06-28,1,0,0,Todas,0,89622
2015-06-29,26,0,0,Todas,0,89648
2015-06-30,18,0,0,Todas,0,89666
2015-07-01,10,0,0,Todas,0,89676
2015-07-02,21,0,0,Todas,0,89697
2015-07-03,23,0,0,Todas,0,89720
2015-07-06,18,0,0,Todas,0,89738
2015-07-08,9,0,0,Todas,0,89747
2015-07-09,19,0,0,Todas,0,89766
2015-07-10,23,0,0,Todas,0,89789
2015-07-11,8,0,0,Todas,0,89797
2015-07-13,25,0,0,Todas,0,89822
2015-07-14,23,0,0,Todas,0,89845
2015-07-15,27,0,0,Todas,0,89872
2015-07-16,16,0,0,Todas,0,89888
2015-07-17,27,0,0,Todas,0,89915
2015-07-20,12,0,0,Todas,0,89927
2015-07-21,15,0,0,Todas,0,89942
2015-07-22,25,0,0,Todas,0,89967
2015-07-23,23,0,0,Todas,0,89990
2015-07-24,19,0,0,Todas,0,90009
2015-07-25,1,0,0,Todas,0,90010
2015-07-27,21,0,0,Todas,0,90031
2015-07-28,17,0,0,Todas,0,90048
2015-07-29,17,0,0,Todas,0,90065
2015-07-30,18,0,0,Todas,0,90083
2015-07-31,19,0,0,Todas,0,90102
2015-08-01,1,0,0,Todas,0,90103
2015-08-02,3,0,0,Todas,0,90106
2015-08-03,18,0,0,Todas,0,90124
2015-08-04,18,0,0,Todas,0,90142
2015-08-05,20,0,0,Todas,0,90162
2015-08-06,22,0,0,Todas,0,90184
2015-08-07,12,0,0,Todas,0,90196
2015-08-11,15,0,0,Todas,0,90211
2015-08-12,21,0,0,Todas,0,90232
2015-08-13,16,0,0,Todas,0,90248
2015-08-14,10,0,0,Todas,0,90258
2015-08-17,21,0,0,Todas,0,90279
2015-08-18,18,0,0,Todas,0,90297
2015-08-19,29,0,0,Todas,0,90326
2015-08-20,33,0,0,Todas,0,90359
2015-08-21,10,0,0,Todas,0,90369
2015-08-24,13,0,0,Todas,0,90382
2015-08-25,16,0,0,Todas,0,90398
2015-08-26,17,0,0,Todas,0,90415
2015-08-27,20,0,0,Todas,0,90435
2015-08-28,17,0,0,Todas,0,90452
2015-08-31,15,0,0,Todas,0,90467
2015-09-01,22,0,0,Todas,0,90489
2015-09-02,22,0,0,Todas,0,90511
2015-09-03,21,0,0,Todas,0,90532
2015-09-04,25,0,0,Todas,0,90557
2015-09-07,7,0,0,Todas,0,90564
2015-09-08,20,0,0,Todas,0,90584
2015-09-09,19,0,0,Todas,0,90603
2015-09-10,20,0,0,Todas,0,90623
2015-09-11,23,0,0,Todas,0,90646
2015-09-14,10,0,0,Todas,0,90656
2015-09-15,19,0,0,Todas,0,90675
2015-09-16,18,0,0,Todas,0,90693
2015-09-17,18,0,0,Todas,0,90711
2015-09-18,20,0,0,Todas,0,90731
2015-09-21,16,0,0,Todas,0,90747
2015-09-22,16,0,0,Todas,0,90763
2015-09-23,19,0,0,Todas,0,90782
2015-09-24,18,0,0,Todas,0,90800
2015-09-25,33,0,0,Todas,0,90833
2015-09-28,18,0,0,Todas,0,90851
2015-09-29,21,0,0,Todas,0,90872
2015-09-30,20,0,0,Todas,0,90892
2015-10-01,22,0,0,Todas,0,90914
2015-10-02,21,0,0,Todas,0,90935
2015-10-05,16,0,0,Todas,0,90951
2015-10-06,27,0,0,Todas,0,90978
2015-10-07,23,0,0,Todas,0,91001
2015-10-08,19,0,0,Todas,0,91020
2015-10-12,17,0,0,Todas,0,91037
2015-10-13,22,0,0,Todas,0,91059
2015-10-14,29,0,0,Todas,0,91088
2015-10-15,19,0,0,Todas,0,91107
2015-10-16,11,0,0,Todas,0,91118
2015-10-19,20,0,0,Todas,0,91138
2015-10-20,21,0,0,Todas,0,91159
2015-10-21,18,0,0,Todas,0,91177
2015-10-22,19,0,0,Todas,0,91196
2015-10-23,21,0,0,Todas,0,91217
2015-10-25,1,0,0,Todas,0,91218
2015-10-26,15,0,0,Todas,0,91233
2015-10-27,33,0,0,Todas,0,91266
2015-10-28,19,0,0,Todas,0,91285
2015-10-29,18,0,0,Todas,0,91303
2015-10-30,13,0,0,Todas,0,91316
2015-11-01,1,0,0,Todas,0,91317
2015-11-04,20,0,0,Todas,0,91337
2015-11-05,17,0,0,Todas,0,91354
2015-11-06,16,0,0,Todas,0,91370
2015-11-07,1,0,0,Todas,0,91371
2015-11-09,16,0,0,Todas,0,91387
2015-11-10,16,0,0,Todas,0,91403
2015-11-11,22,0,0,Todas,0,91425
2015-11-12,26,0,0,Todas,0,91451
2015-11-13,16,0,0,Todas,0,91467
2015-11-15,1,0,0,Todas,0,91468
2015-11-16,18,0,0,Todas,0,91486
2015-11-17,18,0,0,Todas,0,91504
2015-11-18,10,0,0,Todas,0,91514
2015-11-19,18,0,0,Todas,0,91532
2015-11-20,25,0,0,Todas,0,91557
2015-11-23,18,0,0,Todas,0,91575
2015-11-24,24,0,0,Todas,0,91599
2015-11-25,19,0,0,Todas,0,91618
2015-11-26,25,0,0,Todas,0,91643
2015-11-27,10,0,0,Todas,0,91653
2015-11-30,15,0,0,Todas,0,91668
2015-12-01,14,0,0,Todas,0,91682
2015-12-02,18,0,0,Todas,0,91700
2015-12-03,25,0,0,Todas,0,91725
2015-12-04,16,0,0,Todas,0,91741
2015-12-07,19,0,0,Todas,0,91760
2015-12-08,18,0,0,Todas,0,91778
2015-12-09,22,0,0,Todas,0,91800
2015-12-10,20,0,0,Todas,0,91820
2015-12-11,21,0,0,Todas,0,91841
2015-12-12,2,0,0,Todas,0,91843
2015-12-13,1,0,0,Todas,0,91844
2015-12-14,14,0,0,Todas,0,91858
2015-12-15,12,0,0,Todas,0,91870
2015-12-16,22,0,0,Todas,0,91892
2015-12-17,16,0,0,Todas,0,91908
2015-12-18,15,0,0,Todas,0,91923
2015-12-21,10,0,0,Todas,0,91933
2015-12-22,13,0,0,Todas,0,91946
2015-12-23,17,0,0,Todas,0,91963
2015-12-24,12,0,0,Todas,0,91975
2015-12-28,11,0,0,Todas,0,91986
2015-12-29,10,0,0,Todas,0,91996
2015-12-30,9,0,0,Todas,0,92005
2015-12-31,2,0,0,Todas,0,92007
2016-01-01,2,0,0,Todas,0,92009
2016-01-04,15,0,0,Todas,0,92024
2016-01-05,11,0,0,Todas,0,92035
2016-01-06,17,0,0,Todas,0,92052
2016-01-07,20,0,0,Todas,0,92072
2016-01-08,20,0,0,Todas,0,92092
2016-01-09,1,0,0,Todas,0,92093
2016-01-11,13,0,0,Todas,0,92106
2016-01-12,19,0,0,Todas,0,92125
2016-01-13,23,0,0,Todas,0,92148
2016-01-14,14,0,0,Todas,0,92162
2016-01-15,14,0,0,Todas,0,92176
2016-01-16,2,0,0,Todas,0,92178
2016-01-18,9,0,0,Todas,0,92187
2016-01-19,17,0,0,Todas,0,92204
2016-01-20,21,0,0,Todas,0,92225
2016-01-21,24,0,0,Todas,0,92249
2016-01-22,18,0,0,Todas,0,92267
2016-01-25,20,0,0,Todas,0,92287
2016-01-26,27,0,0,Todas,0,92314
2016-01-27,25,0,0,Todas,0,92339
2016-01-28,22,0,0,Todas,0,92361
2016-01-29,20,0,0,Todas,0,92381
2016-02-01,23,0,0,Todas,0,92404
2016-02-02,15,0,0,Todas,0,92419
2016-02-03,15,0,0,Todas,0,92434
2016-02-04,16,0,0,Todas,0,92450
2016-02-05,24,0,0,Todas,0,92474
2016-02-10,18,0,0,Todas,0,92492
2016-02-11,17,0,0,Todas,0,92509
2016-02-12,16,0,0,Todas,0,92525
2016-02-13,15,0,0,Todas,0,92540
2016-02-14,1,0,0,Todas,0,92541
2016-02-15,15,0,0,Todas,0,92556
2016-02-16,15,0,0,Todas,0,92571
2016-02-17,19,0,0,Todas,0,92590
2016-02-18,18,0,0,Todas,0,92608
2016-02-19,14,0,0,Todas,0,92622
2016-02-20,6,0,0,Todas,0,92628
2016-02-22,14,0,0,Todas,0,92642
2016-02-23,22,0,0,Todas,0,92664
2016-02-24,23,0,0,Todas,0,92687
2016-02-25,23,0,0,Todas,0,92710
2016-02-26,19,0,0,Todas,0,92729
2016-02-29,12,0,0,Todas,0,92741
2016-03-01,25,0,0,Todas,0,92766
2016-03-02,16,0,0,Todas,0,92782
2016-03-03,23,0,0,Todas,0,92805
2016-03-04,19,0,0,Todas,0,92824
2016-03-05,1,0,0,Todas,0,92825
2016-03-07,20,0,0,Todas,0,92845
2016-03-08,15,0,0,Todas,0,92860
2016-03-09,22,0,0,Todas,0,92882
2016-03-10,17,0,0,Todas,0,92899
2016-03-11,15,0,0,Todas,0,92914
2016-03-12,5,0,0,Todas,0,92919
2016-03-14,16,0,0,Todas,0,92935
2016-03-15,22,0,0,Todas,0,92957
2016-03-16,18,0,0,Todas,0,92975
2016-03-17,18,0,0,Todas,0,92993
2016-03-18,17,0,0,Todas,0,93010
2016-03-21,12,0,0,Todas,0,93022
2016-03-22,25,0,0,Todas,0,93047
2016-03-23,9,0,0,Todas,0,93056
2016-03-24,25,0,0,Todas,0,93081
2016-03-28,35,0,0,Todas,0,93116
2016-03-29,17,0,0,Todas,0,93133
2016-03-30,11,0,0,Todas,0,93144
2016-03-31,17,0,0,Todas,0,93161
2016-04-01,29,0,0,Todas,0,93190
2016-04-04,20,0,0,Todas,0,93210
2016-04-05,31,0,0,Todas,0,93241
2016-04-06,24,0,0,Todas,0,93265
2016-04-07,17,0,0,Todas,0,93282
2016-04-08,20,0,0,Todas,0,93302
2016-04-11,19,0,0,Todas,0,93321
2016-04-12,23,0,0,Todas,0,93344
2016-04-13,23,0,0,Todas,0,93367
2016-04-14,20,0,0,Todas,0,93387
2016-04-15,22,0,0,Todas,0,93409
2016-04-18,28,0,0,Todas,0,93437
2016-04-19,19,0,0,Todas,0,93456
2016-04-20,25,0,0,Todas,0,93481
2016-04-21,17,0,0,Todas,0,93498
2016-04-22,22,0,0,Todas,0,93520
2016-04-24,1,0,0,Todas,0,93521
2016-04-25,20,0,0,Todas,0,93541
2016-04-26,16,0,0,Todas,0,93557
2016-04-27,29,0,0,Todas,0,93586
2016-04-28,20,0,0,Todas,0,93606
2016-04-29,15,0,0,Todas,0,93621
2016-05-01,1,0,0,Todas,0,93622
2016-05-02,14,0,0,Todas,0,93636
2016-05-03,17,0,0,Todas,0,93653
2016-05-04,16,0,0,Todas,0,93669
2016-05-05,13,0,0,Todas,0,93682
2016-05-06,21,0,0,Todas,0,93703
2016-05-09,20,0,0,Todas,0,93723
2016-05-10,24,0,0,Todas,0,93747
2016-05-11,16,0,0,Todas,0,93763
2016-05-12,25,0,0,Todas,0,93788
2016-05-13,24,0,0,Todas,0,93812
2016-05-15,1,0,0,Todas,0,93813
2016-05-16,26,0,0,Todas,0,93839
2016-05-17,26,0,0,Todas,0,93865
2016-05-18,14,0,0,Todas,0,93879
2016-05-19,17,0,0,Todas,0,93896
2016-05-20,17,0,0,Todas,0,93913
2016-05-23,12,0,0,Todas,0,93925
2016-05-24,12,0,0,Todas,0,93937
2016-05-25,24,0,0,Todas,0,93961
2016-05-26,22,0,0,Todas,0,93983
2016-05-30,26,0,0,Todas,0,94009
2016-05-31,15,0,0,Todas,0,94024
2016-06-01,28,0,0,Todas,0,94052
2016-06-02,24,0,0,Todas,0,94076
2016-06-03,18,0,0,Todas,0,94094
2016-06-06,15,0,0,Todas,0,94109
2016-06-07,16,0,0,Todas,0,94125
2016-06-08,14,0,0,Todas,0,94139
2016-06-09,16,0,0,Todas,0,94155
2016-06-10,22,0,0,Todas,0,94177
2016-06-12,1,0,0,Todas,0,94178
2016-06-13,15,0,0,Todas,0,94193
2016-06-14,12,0,0,Todas,0,94205
2016-06-15,12,0,0,Todas,0,94217
2016-06-16,24,0,0,Todas,0,94241
2016-06-17,17,0,0,Todas,0,94258
2016-06-20,22,0,0,Todas,0,94280
2016-06-21,20,0,0,Todas,0,94300
2016-06-22,27,0,0,Todas,0,94327
2016-06-23,18,0,0,Todas,0,94345
2016-06-24,15,0,0,Todas,0,94360
2016-06-27,18,0,0,Todas,0,94378
2016-06-28,23,0,0,Todas,0,94401
2016-06-29,17,0,0,Todas,0,94418
2016-06-30,20,0,0,Todas,0,94438
2016-07-01,13,0,0,Todas,0,94451
2016-07-04,13,0,0,Todas,0,94464
2016-07-05,23,0,0,Todas,0,94487
2016-07-06,22,0,0,Todas,0,94509
2016-07-07,12,0,0,Todas,0,94521
2016-07-08,21,0,0,Todas,0,94542
2016-07-11,18,0,0,Todas,0,94560
2016-07-12,18,0,0,Todas,0,94578
2016-07-13,25,0,0,Todas,0,94603
2016-07-14,15,0,0,Todas,0,94618
2016-07-15,11,0,0,Todas,0,94629
2016-07-18,14,0,0,Todas,0,94643
2016-07-19,26,0,0,Todas,0,94669
2016-07-20,15,0,0,Todas,0,94684
2016-07-21,28,0,0,Todas,0,94712
2016-07-22,22,0,0,Todas,0,94734
2016-07-25,12,0,0,Todas,0,94746
2016-07-26,15,0,0,Todas,0,94761
2016-07-27,11,0,0,Todas,0,94772
2016-07-28,13,0,0,Todas,0,94785
2016-07-29,13,0,0,Todas,0,94798
2016-08-01,16,0,0,Todas,0,94814
2016-08-02,21,0,0,Todas,0,94835
2016-08-03,20,0,0,Todas,0,94855
2016-08-04,13,0,0,Todas,0,94868
2016-08-05,22,0,0,Todas,0,94890
2016-08-08,14,0,0,Todas,0,94904
2016-08-09,22,0,0,Todas,0,94926
2016-08-10,20,0,0,Todas,0,94946
2016-08-11,27,0,0,Todas,0,94973
2016-08-15,19,0,0,Todas,0,94992
2016-08-16,21,0,0,Todas,0,95013
2016-08-17,11,0,0,Todas,0,95024
2016-08-18,21,0,0,Todas,0,95045
2016-08-19,19,0,0,Todas,0,95064
2016-08-22,17,0,0,Todas,0,95081
2016-08-23,14,0,0,Todas,0,95095
2016-08-24,12,0,0,Todas,0,95107
2016-08-25,16,0,0,Todas,0,95123
2016-08-26,15,0,0,Todas,0,95138
2016-08-29,22,0,0,Todas,0,95160
2016-08-30,20,0,0,Todas,0,95180
2016-08-31,20,0,0,Todas,0,95200
2016-09-01,28,0,0,Todas,0,95228
2016-09-02,19,0,0,Todas,0,95247
2016-09-05,12,0,0,Todas,0,95259
2016-09-06,18,0,0,Todas,0,95277
2016-09-07,29,0,0,Todas,0,95306
2016-09-08,15,0,0,Todas,0,95321
2016-09-09,20,0,0,Todas,0,95341
2016-09-12,15,0,0,Todas,0,95356
2016-09-13,18,0,0,Todas,0,95374
2016-09-14,21,0,0,Todas,0,95395
2016-09-15,23,0,0,Todas,0,95418
2016-09-16,15,0,0,Todas,0,95433
2016-09-19,6,0,0,Todas,0,95439
2016-09-20,24,0,0,Todas,0,95463
2016-09-21,24,0,0,Todas,0,95487
2016-09-22,17,0,0,Todas,0,95504
2016-09-23,19,0,0,Todas,0,95523
2016-09-26,13,0,0,Todas,0,95536
2016-09-27,25,0,0,Todas,0,95561
2016-09-28,24,0,0,Todas,0,95585
2016-09-29,22,0,0,Todas,0,95607
2016-09-30,21,0,0,Todas,0,95628
2016-10-01,1,0,0,Todas,0,95629
2016-10-03,22,0,0,Todas,0,95651
2016-10-04,19,0,0,Todas,0,95670
2016-10-05,21,0,0,Todas,0,95691
2016-10-06,17,0,0,Todas,0,95708
2016-10-07,20,0,0,Todas,0,95728
2016-10-10,14,0,0,Todas,0,95742
2016-10-11,26,0,0,Todas,0,95768
2016-10-12,19,0,0,Todas,0,95787
2016-10-13,15,0,0,Todas,0,95802
2016-10-14,22,0,0,Todas,0,95824
2016-10-17,19,0,0,Todas,0,95843
2016-10-18,23,0,0,Todas,0,95866
2016-10-19,21,0,0,Todas,0,95887
2016-10-20,25,0,0,Todas,0,95912
2016-10-21,23,0,0,Todas,0,95935
2016-10-24,21,0,0,Todas,0,95956
2016-10-25,18,0,0,Todas,0,95974
2016-10-26,20,0,0,Todas,0,95994
2016-10-27,19,0,0,Todas,0,96013
2016-10-28,14,0,0,Todas,0,96027
2016-10-31,25,0,0,Todas,0,96052
2016-11-01,25,0,0,Todas,0,96077
2016-11-07,20,0,0,Todas,0,96097
2016-11-08,15,0,0,Todas,0,96112
2016-11-09,22,0,0,Todas,0,96134
2016-11-10,26,0,0,Todas,0,96160
2016-11-11,18,0,0,Todas,0,96178
2016-11-12,9,0,0,Todas,0,96187
2016-11-14,25,0,0,Todas,0,96212
2016-11-15,12,0,0,Todas,0,96224
2016-11-16,21,0,0,Todas,0,96245
2016-11-17,18,0,0,Todas,0,96263
2016-11-18,16,0,0,Todas,0,96279
2016-11-21,21,0,0,Todas,0,96300
2016-11-22,14,0,0,Todas,0,96314
2016-11-23,27,0,0,Todas,0,96341
2016-11-24,16,0,0,Todas,0,96357
2016-11-25,18,0,0,Todas,0,96375
2016-11-27,1,0,0,Todas,0,96376
2016-11-28,14,0,0,Todas,0,96390
2016-11-29,21,0,0,Todas,0,96411
2016-11-30,16,0,0,Todas,0,96427
2016-12-01,21,0,0,Todas,0,96448
2016-12-02,21,0,0,Todas,0,96469
2016-12-05,23,0,0,Todas,0,96492
2016-12-07,24,0,0,Todas,0,96516
2016-12-08,13,0,0,Todas,0,96529
2016-12-09,16,0,0,Todas,0,96545
2016-12-12,25,0,0,Todas,0,96570
2016-12-13,13,0,0,Todas,0,96583
2016-12-14,14,0,0,Todas,0,96597
2016-12-15,21,0,0,Todas,0,96618
2016-12-16,27,0,0,Todas,0,96645
2016-12-19,25,0,0,Todas,0,96670
2016-12-20,30,0,0,Todas,0,96700
2016-12-21,28,0,0,Todas,0,96728
2016-12-22,25,0,0,Todas,0,96753
2016-12-23,30,0,0,Todas,0,96783
2016-12-27,26,0,0,Todas,0,96809
2016-12-28,26,0,0,Todas,0,96835
2016-12-29,27,0,0,Todas,0,96862
2016-12-30,16,0,0,Todas,0,96878
2017-01-01,3,0,0,Todas,0,96881
2017-01-03,18,0,0,Todas,0,96899
2017-01-04,17,0,0,Todas,0,96916
2017-01-05,23,0,0,Todas,0,96939
2017-01-06,10,0,0,Todas,0,96949
2017-01-09,21,0,0,Todas,0,96970
2017-01-10,24,0,0,Todas,0,96994
2017-01-11,17,0,0,Todas,0,97011
2017-01-12,18,0,0,Todas,0,97029
2017-01-13,21,0,0,Todas,0,97050
2017-01-16,18,0,0,Todas,0,97068
2017-01-17,25,0,0,Todas,0,97093
2017-01-18,34,0,0,Todas,0,97127
2017-01-19,22,0,0,Todas,0,97149
2017-01-20,28,0,0,Todas,0,97177
2017-01-23,23,0,0,Todas,0,97200
2017-01-24,25,0,0,Todas,0,97225
2017-01-25,18,0,0,Todas,0,97243
2017-01-26,21,0,0,Todas,0,97264
2017-01-27,24,0,0,Todas,0,97288
2017-01-30,14,0,0,Todas,0,97302
2017-01-31,18,0,0,Todas,0,97320
2017-02-01,16,0,0,Todas,0,97336
2017-02-02,32,0,0,Todas,0,97368
2017-02-03,26,0,0,Todas,0,97394
2017-02-06,14,0,0,Todas,0,97408
2017-02-07,18,0,0,Todas,0,97426
2017-02-08,19,0,0,Todas,0,97445
2017-02-09,13,0,0,Todas,0,97458
2017-02-10,16,0,0,Todas,0,97474
2017-02-12,1,0,0,Todas,0,97475
2017-02-13,16,0,0,Todas,0,97491
2017-02-14,15,0,0,Todas,0,97506
2017-02-15,16,0,0,Todas,0,97522
2017-02-16,18,0,0,Todas,0,97540
2017-02-17,14,0,0,Todas,0,97554
2017-02-20,11,0,0,Todas,0,97565
2017-02-21,15,0,0,Todas,0,97580
2017-02-22,24,0,0,Todas,0,97604
2017-02-23,14,0,0,Todas,0,97618
2017-02-24,17,0,0,Todas,0,97635
2017-03-01,18,0,0,Todas,0,97653
2017-03-02,26,0,0,Todas,0,97679
2017-03-03,26,0,0,Todas,0,97705
2017-03-06,19,0,0,Todas,0,97724
2017-03-07,17,0,0,Todas,0,97741
2017-03-08,28,0,0,Todas,0,97769
2017-03-09,23,0,0,Todas,0,97792
2017-03-10,14,0,0,Todas,0,97806
2017-03-13,17,0,0,Todas,0,97823
2017-03-14,16,0,0,Todas,0,97839
2017-03-15,15,0,0,Todas,0,97854
2017-03-16,19,0,0,Todas,0,97873
2017-03-17,13,0,0,Todas,0,97886
2017-03-20,16,0,0,Todas,0,97902
2017-03-21,17,0,0,Todas,0,97919
2017-03-22,12,0,0,Todas,0,97931
2017-03-23,16,0,0,Todas,0,97947
2017-03-24,16,0,0,Todas,0,97963
2017-03-27,23,0,0,Todas,0,97986
2017-03-28,15,0,0,Todas,0,98001
2017-03-29,22,0,0,Todas,0,98023
2017-03-30,21,0,0,Todas,0,98044
2017-03-31,20,0,0,Todas,0,98064
2017-04-01,2,0,0,Todas,0,98066
2017-04-03,23,0,0,Todas,0,98089
2017-04-04,16,0,0,Todas,0,98105
2017-04-05,16,0,0,Todas,0,98121
2017-04-06,16,0,0,Todas,0,98137
2017-04-07,24,0,0,Todas,0,98161
2017-04-10,14,0,0,Todas,0,98175
2017-04-11,31,0,0,Todas,0,98206
2017-04-12,21,0,0,Todas,0,98227
2017-04-13,15,0,0,Todas,0,98242
2017-04-16,1,0,0,Todas,0,98243
2017-04-17,13,0,0,Todas,0,98256
2017-04-18,14,0,0,Todas,0,98270
2017-04-19,18,0,0,Todas,0,98288
2017-04-20,11,0,0,Todas,0,98299
2017-04-21,14,0,0,Todas,0,98313
2017-04-24,18,0,0,Todas,0,98331
2017-04-25,16,0,0,Todas,0,98347
2017-04-26,23,0,0,Todas,0,98370
2017-04-27,12,0,0,Todas,0,98382
2017-04-28,14,0,0,Todas,0,98396
2017-05-02,19,0,0,Todas,0,98415
2017-05-03,8,0,0,Todas,0,98423
2017-05-04,11,0,0,Todas,0,98434
2017-05-05,16,0,0,Todas,0,98450
2017-05-08,18,0,0,Todas,0,98468
2017-05-09,17,0,0,Todas,0,98485
2017-05-10,24,0,0,Todas,0,98509
2017-05-11,17,0,0,Todas,0,98526
2017-05-12,20,0,0,Todas,0,98546
2017-05-13,1,0,0,Todas,0,98547
2017-05-15,20,0,0,Todas,0,98567
2017-05-16,28,0,0,Todas,0,98595
2017-05-17,26,0,0,Todas,0,98621
2017-05-18,32,0,0,Todas,0,98653
2017-05-19,29,0,0,Todas,0,98682
2017-05-22,22,0,0,Todas,0,98704
2017-05-23,23,0,0,Todas,0,98727
2017-05-24,21,0,0,Todas,0,98748
2017-05-25,20,0,0,Todas,0,98768
2017-05-29,20,0,0,Todas,0,98788
2017-05-30,16,0,0,Todas,0,98804
2017-05-31,27,0,0,Todas,0,98831
2017-06-01,25,0,0,Todas,0,98856
2017-06-02,19,0,0,Todas,0,98875
2017-06-04,1,0,0,Todas,0,98876
2017-06-05,20,0,0,Todas,0,98896
2017-06-06,27,0,0,Todas,0,98923
2017-06-07,23,0,0,Todas,0,98946
2017-06-08,28,0,0,Todas,0,98974
2017-06-09,27,0,0,Todas,0,99001
2017-06-12,16,0,0,Todas,0,99017
2017-06-13,18,0,0,Todas,0,99035
2017-06-14,26,0,0,Todas,0,99061
2017-06-15,21,0,0,Todas,0,99082
2017-06-16,24,0,0,Todas,0,99106
2017-06-19,17,0,0,Todas,0,99123
2017-06-20,24,0,0,Todas,0,99147
2017-06-21,19,0,0,Todas,0,99166
2017-06-22,16,0,0,Todas,0,99182
2017-06-23,31,0,0,Todas,0,99213
2017-06-26,20,0,0,Todas,0,99233
2017-06-27,28,0,0,Todas,0,99261
2017-06-28,12,0,0,Todas,0,99273
2017-06-29,22,0,0,Todas,0,99295
2017-06-30,15,0,0,Todas,0,99310
2017-07-01,1,0,0,Todas,0,99311
2017-07-03,20,0,0,Todas,0,99331
2017-07-04,19,0,0,Todas,0,99350
2017-07-05,13,0,0,Todas,0,99363
2017-07-06,17,0,0,Todas,0,99380
2017-07-07,24,0,0,Todas,0,99404
2017-07-10,15,0,0,Todas,0,99419
2017-07-11,26,0,0,Todas,0,99445
2017-07-12,13,0,0,Todas,0,99458
2017-07-13,16,0,0,Todas,0,99474
2017-07-14,17,0,0,Todas,0,99491
2017-07-17,22,0,0,Todas,0,99513
2017-07-18,31,0,0,Todas,0,99544
2017-07-19,22,0,0,Todas,0,99566
2017-07-20,14,0,0,Todas,0,99580
2017-07-21,24,0,0,Todas,0,99604
2017-07-24,24,0,0,Todas,0,99628
2017-07-25,26,0,0,Todas,0,99654
2017-07-26,20,0,0,Todas,0,99674
2017-07-27,25,0,0,Todas,0,99699
2017-07-28,22,0,0,Todas,0,99721
2017-07-31,19,0,0,Todas,0,99740
2017-08-01,28,0,0,Todas,0,99768
2017-08-02,16,0,0,Todas,0,99784
2017-08-03,25,0,0,Todas,0,99809
2017-08-04,21,0,0,Todas,0,99830
2017-08-07,15,0,0,Todas,0,99845
2017-08-08,17,0,0,Todas,0,99862
2017-08-09,19,0,0,Todas,0,99881
2017-08-10,23,0,0,Todas,0,99904
2017-08-14,18,0,0,Todas,0,99922
2017-08-15,17,0,0,Todas,0,99939
2017-08-16,19,0,0,Todas,0,99958
2017-08-17,16,0,0,Todas,0,99974
2017-08-18,21,0,0,Todas,0,99995
2017-08-21,19,0,0,Todas,0,100014
2017-08-22,20,0,0,Todas,0,100034
2017-08-23,23,0,0,Todas,0,100057
2017-08-24,22,0,0,Todas,0,100079
2017-08-25,30,0,0,Todas,0,100109
2017-08-27,1,0,0,Todas,0,100110
2017-08-28,15,0,0,Todas,0,100125
2017-08-29,19,0,0,Todas,0,100144
2017-08-30,19,0,0,Todas,0,100163
2017-08-31,22,0,0,Todas,0,100185
2017-09-01,21,0,0,Todas,0,100206
2017-09-04,21,0,0,Todas,0,100227
2017-09-05,12,0,0,Todas,0,100239
2017-09-06,22,0,0,Todas,0,100261
2017-09-07,19,0,0,Todas,0,100280
2017-09-08,21,0,0,Todas,0,100301
2017-09-11,18,0,0,Todas,0,100319
2017-09-12,20,0,0,Todas,0,100339
2017-09-13,19,0,0,Todas,0,100358
2017-09-14,18,0,0,Todas,0,100376
2017-09-15,18,0,0,Todas,0,100394
2017-09-18,16,0,0,Todas,0,100410
2017-09-19,21,0,0,Todas,0,100431
2017-09-20,19,0,0,Todas,0,100450
2017-09-21,26,0,0,Todas,0,100476
2017-09-22,20,0,0,Todas,0,100496
2017-09-25,19,0,0,Todas,0,100515
2017-09-26,15,0,0,Todas,0,100530
2017-09-27,28,0,0,Todas,0,100558
2017-09-28,18,0,0,Todas,0,100576
2017-09-29,17,0,0,Todas,0,100593
2017-10-01,1,0,0,Todas,0,100594
2017-10-02,27,0,0,Todas,0,100621
2017-10-03,20,0,0,Todas,0,100641
2017-10-04,19,0,0,Todas,0,100660
2017-10-05,24,0,0,Todas,0,100684
2017-10-06,25,0,0,Todas,0,100709
2017-10-10,17,0,0,Todas,0,100726
2017-10-11,24,0,0,Todas,0,100750
2017-10-12,16,0,0,Todas,0,100766
2017-10-13,20,0,0,Todas,0,100786
2017-10-15,1,0,0,Todas,0,100787
2017-10-16,21,0,0,Todas,0,100808
2017-10-17,27,0,0,Todas,0,100835
2017-10-18,22,0,0,Todas,0,100857
2017-10-19,27,0,0,Todas,0,100884
2017-10-20,27,0,0,Todas,0,100911
2017-10-21,1,0,0,Todas,0,100912
2017-10-23,19,0,0,Todas,0,100931
2017-10-24,23,0,0,Todas,0,100954
2017-10-25,14,0,0,Todas,0,100968
2017-10-26,31,0,0,Todas,0,100999
2017-10-27,21,0,0,Todas,0,101020
2017-10-29,1,0,0,Todas,0,101021
2017-10-30,23,0,0,Todas,0,101044
2017-10-31,26,0,0,Todas,0,101070
2017-11-01,33,0,0,Todas,0,101103
2017-11-06,18,0,0,Todas,0,101121
2017-11-07,31,0,0,Todas,0,101152
2017-11-08,31,0,0,Todas,0,101183
2017-11-09,27,0,0,Todas,0,101210
2017-11-10,18,0,0,Todas,0,101228
2017-11-13,17,0,0,Todas,0,101245
2017-11-14,18,0,0,Todas,0,101263
2017-11-15,26,0,0,Todas,0,101289
2017-11-16,21,0,0,Todas,0,101310
2017-11-17,20,0,0,Todas,0,101330
2017-11-20,18,0,0,Todas,0,101348
2017-11-21,17,0,0,Todas,0,101365
2017-11-22,19,0,0,Todas,0,101384
2017-11-23,22,0,0,Todas,0,101406
2017-11-24,15,0,0,Todas,0,101421
2017-11-27,21,0,0,Todas,0,101442
2017-11-28,21,0,0,Todas,0,101463
2017-11-29,24,0,0,Todas,0,101487
2017-11-30,23,0,0,Todas,0,101510
2017-12-01,21,0,0,Todas,0,101531
2017-12-03,1,0,0,Todas,0,101532
2017-12-04,13,0,0,Todas,0,101545
2017-12-05,14,0,0,Todas,0,101559
2017-12-06,1,0,0,Todas,0,101560
2017-12-07,15,0,0,Todas,0,101575
2017-12-08,3,0,0,Todas,0,101578
2017-12-11,30,0,0,Todas,0,101608
2017-12-12,29,0,0,Todas,0,101637
2017-12-13,21,0,0,Todas,0,101658
2017-12-14,13,0,0,Todas,0,101671
2017-12-15,18,0,0,Todas,0,101689
2017-12-18,20,0,0,Todas,0,101709
2017-12-19,16,0,0,Todas,0,101725
2017-12-20,17,0,0,Todas,0,101742
2017-12-21,25,0,0,Todas,0,101767
2017-12-22,15,0,0,Todas,0,101782
2017-12-26,16,0,0,Todas,0,101798
2017-12-27,19,0,0,Todas,0,101817
2017-12-28,13,0,0,Todas,0,101830
2017-12-29,18,0,0,Todas,0,101848
2018-01-02,18,0,0,Todas,0,101866
2018-01-03,9,0,0,Todas,0,101875
2018-01-04,19,0,0,Todas,0,101894
2018-01-05,15,0,0,Todas,0,101909
2018-01-08,21,0,0,Todas,0,101930
2018-01-09,15,0,0,Todas,0,101945
2018-01-10,27,0,0,Todas,0,101972
2018-01-11,20,0,0,Todas,0,101992
2018-01-12,24,0,0,Todas,0,102016
2018-01-15,18,0,0,Todas,0,102034
2018-01-16,17,0,0,Todas,0,102051
2018-01-17,9,0,0,Todas,0,102060
2018-01-18,17,0,0,Todas,0,102077
2018-01-19,23,0,0,Todas,0,102100
2018-01-22,22,0,0,Todas,0,102122
2018-01-23,23,0,0,Todas,0,102145
2018-01-24,52,0,0,Todas,0,102197
2018-01-25,20,0,0,Todas,0,102217
2018-01-26,24,0,0,Todas,0,102241
2018-01-27,2,0,0,Todas,0,102243
2018-01-29,24,0,0,Todas,0,102267
2018-01-30,29,0,0,Todas,0,102296
2018-01-31,27,0,0,Todas,0,102323
2018-02-01,26,0,0,Todas,0,102349
2018-02-02,39,0,0,Todas,0,102388
2018-02-05,17,0,0,Todas,0,102405
2018-02-06,23,0,0,Todas,0,102428
2018-02-07,19,0,0,Todas,0,102447
2018-02-08,23,0,0,Todas,0,102470
2018-02-09,32,0,0,Todas,0,102502
2018-02-14,20,0,0,Todas,0,102522
2018-02-15,22,0,0,Todas,0,102544
2018-02-16,22,0,0,Todas,0,102566
2018-02-19,17,0,0,Todas,0,102583
2018-02-20,19,0,0,Todas,0,102602
2018-02-21,18,0,0,Todas,0,102620
2018-02-22,18,0,0,Todas,0,102638
2018-02-23,27,0,0,Todas,0,102665
2018-02-26,16,0,0,Todas,0,102681
2018-02-27,16,0,0,Todas,0,102697
2018-02-28,27,0,0,Todas,0,102724
2018-03-01,32,0,0,Todas,0,102756
2018-03-02,20,0,0,Todas,0,102776
2018-03-05,15,0,0,Todas,0,102791
2018-03-06,27,0,0,Todas,0,102818
2018-03-07,25,0,0,Todas,0,102843
2018-03-08,26,0,0,Todas,0,102869
2018-03-09,20,0,0,Todas,0,102889
2018-03-12,19,0,0,Todas,0,102908
2018-03-13,18,0,0,Todas,0,102926
2018-03-14,36,0,0,Todas,0,102962
2018-03-15,24,0,0,Todas,0,102986
2018-03-16,25,0,0,Todas,0,103011
2018-03-19,15,0,0,Todas,0,103026
2018-03-20,19,0,0,Todas,0,103045
2018-03-21,22,0,0,Todas,0,103067
2018-03-22,23,0,0,Todas,0,103090
2018-03-23,27,0,0,Todas,0,103117
2018-03-26,21,0,0,Todas,0,103138
2018-03-27,25,0,0,Todas,0,103163
2018-03-28,27,0,0,Todas,0,103190
2018-03-29,31,0,0,Todas,0,103221
2018-04-02,23,0,0,Todas,0,103244
2018-04-03,32,0,0,Todas,0,103276
2018-04-04,23,0,0,Todas,0,103299
2018-04-05,20,0,0,Todas,0,103319
2018-04-06,31,0,0,Todas,0,103350
2018-04-09,25,0,0,Todas,0,103375
2018-04-10,20,0,0,Todas,0,103395
2018-04-11,26,0,0,Todas,0,103421
2018-04-12,19,0,0,Todas,0,103440
2018-04-13,23,0,0,Todas,0,103463
2018-04-16,21,0,0,Todas,0,103484
2018-04-17,19,0,0,Todas,0,103503
2018-04-18,17,0,0,Todas,0,103520
2018-04-19,21,0,0,Todas,0,103541
2018-04-20,15,0,0,Todas,0,103556
2018-04-23,25,0,0,Todas,0,103581
2018-04-24,21,0,0,Todas,0,103602
2018-04-25,26,0,0,Todas,0,103628
2018-04-26,30,0,0,Todas,0,103658
2018-04-27,20,0,0,Todas,0,103678
2018-05-01,1,0,0,Todas,0,103679
2018-05-02,19,0,0,Todas,0,103698
2018-05-03,27,0,0,Todas,0,103725
2018-05-04,31,0,0,Todas,0,103756
2018-05-07,30,0,0,Todas,0,103786
2018-05-08,23,0,0,Todas,0,103809
2018-05-09,24,0,0,Todas,0,103833
2018-05-10,19,0,0,Todas,0,103852
2018-05-11,28,0,0,Todas,0,103880
2018-05-14,23,0,0,Todas,0,103903
2018-05-15,27,0,0,Todas,0,103930
2018-05-16,17,0,0,Todas,0,103947
2018-05-17,25,0,0,Todas,0,103972
2018-05-18,32,0,0,Todas,0,104004
2018-05-21,21,0,0,Todas,0,104025
2018-05-22,22,0,0,Todas,0,104047
2018-05-23,16,0,0,Todas,0,104063
2018-05-24,23,0,0,Todas,0,104086
2018-05-28,20,0,0,Todas,0,104106
2018-05-29,20,0,0,Todas,0,104126
2018-05-30,27,0,0,Todas,0,104153
2018-05-31,21,0,0,Todas,0,104174
2018-06-01,28,0,0,Todas,0,104202
2018-06-04,23,0,0,Todas,0,104225
2018-06-05,26,0,0,Todas,0,104251
2018-06-06,15,0,0,Todas,0,104266
2018-06-07,16,0,0,Todas,0,104282
2018-06-08,15,0,0,Todas,0,104297
2018-06-11,22,0,0,Todas,0,104319
2018-06-12,24,0,0,Todas,0,104343
2018-06-13,24,0,0,Todas,0,104367
2018-06-14,29,0,0,Todas,0,104396
2018-06-15,33,0,0,Todas,0,104429
2018-06-18,10,0,0,Todas,0,104439
2018-06-19,21,0,0,Todas,0,104460
2018-06-20,23,0,0,Todas,0,104483
2018-06-21,20,0,0,Todas,0,104503
2018-06-22,14,0,0,Todas,0,104517
2018-06-25,16,0,0,Todas,0,104533
2018-06-26,22,0,0,Todas,0,104555
2018-06-27,14,0,0,Todas,0,104569
2018-06-28,24,0,0,Todas,0,104593
2018-06-29,17,0,0,Todas,0,104610
2018-07-01,1,0,0,Todas,0,104611
2018-07-02,13,0,0,Todas,0,104624
2018-07-03,20,0,0,Todas,0,104644
2018-07-04,21,0,0,Todas,0,104665
2018-07-05,24,0,0,Todas,0,104689
2018-07-06,23,0,0,Todas,0,104712
2018-07-09,14,0,0,Todas,0,104726
2018-07-10,15,0,0,Todas,0,104741
2018-07-11,14,0,0,Todas,0,104755
2018-07-12,22,0,0,Todas,0,104777
2018-07-13,18,0,0,Todas,0,104795
2018-07-16,8,0,0,Todas,0,104803
2018-07-17,26,0,0,Todas,0,104829
2018-07-18,26,0,0,Todas,0,104855
2018-07-19,17,0,0,Todas,0,104872
2018-07-20,18,0,0,Todas,0,104890
2018-07-23,13,0,0,Todas,0,104903
2018-07-24,24,0,0,Todas,0,104927
2018-07-25,22,0,0,Todas,0,104949
2018-07-26,19,0,0,Todas,0,104968
2018-07-27,17,0,0,Todas,0,104985
2018-07-30,25,0,0,Todas,0,105010
2018-07-31,17,0,0,Todas,0,105027
2018-08-01,26,0,0,Todas,0,105053
2018-08-02,24,0,0,Todas,0,105077
2018-08-03,27,0,0,Todas,0,105104
2018-08-06,23,0,0,Todas,0,105127
2018-08-07,21,0,0,Todas,0,105148
2018-08-08,21,0,0,Todas,0,105169
2018-08-09,15,0,0,Todas,0,105184
2018-08-13,29,0,0,Todas,0,105213
2018-08-14,18,0,0,Todas,0,105231
2018-08-15,19,0,0,Todas,0,105250
2018-08-16,15,0,0,Todas,0,105265
2018-08-17,18,0,0,Todas,0,105283
2018-08-18,2,0,0,Todas,0,105285
2018-08-19,1,0,0,Todas,0,105286
2018-08-20,14,0,0,Todas,0,105300
2018-08-21,27,0,0,Todas,0,105327
2018-08-22,27,0,0,Todas,0,105354
2018-08-23,12,0,0,Todas,0,105366
2018-08-24,17,0,0,Todas,0,105383
2018-08-27,16,0,0,Todas,0,105399
2018-08-28,23,0,0,Todas,0,105422
2018-08-29,26,0,0,Todas,0,105448
2018-08-30,21,0,0,Todas,0,105469
2018-08-31,15,0,0,Todas,0,105484
2018-09-02,1,0,0,Todas,0,105485
2018-09-03,19,0,0,Todas,0,105504
2018-09-04,17,0,0,Todas,0,105521
2018-09-05,20,0,0,Todas,0,105541
2018-09-06,26,0,0,Todas,0,105567
2018-09-07,19,0,0,Todas,0,105586
2018-09-10,20,0,0,Todas,0,105606
2018-09-11,23,0,0,Todas,0,105629
2018-09-12,21,0,0,Todas,0,105650
2018-09-13,20,0,0,Todas,0,105670
2018-09-14,15,0,0,Todas,0,105685
2018-09-17,20,0,0,Todas,0,105705
2018-09-18,20,0,0,Todas,0,105725
2018-09-19,22,0,0,Todas,0,105747
2018-09-20,25,0,0,Todas,0,105772
2018-09-21,30,0,0,Todas,0,105802
2018-09-23,2,0,0,Todas,0,105804
2018-09-24,17,0,0,Todas,0,105821
2018-09-25,12,0,0,Todas,0,105833
2018-09-26,28,0,0,Todas,0,105861
2018-09-27,30,0,0,Todas,0,105891
2018-09-28,22,0,0,Todas,0,105913
2018-09-30,2,0,0,Todas,0,105915
2018-10-01,29,0,0,Todas,0,105944
2018-10-02,14,0,0,Todas,0,105958
2018-10-03,18,0,0,Todas,0,105976
2018-10-04,24,0,0,Todas,0,106000
2018-10-05,29,0,0,Todas,0,106029
2018-10-09,9,0,0,Todas,0,106038
2018-10-10,17,0,0,Todas,0,106055
2018-10-11,21,0,0,Todas,0,106076
2018-10-12,20,0,0,Todas,0,106096
2018-10-14,1,0,0,Todas,0,106097
2018-10-15,15,0,0,Todas,0,106112
2018-10-16,26,0,0,Todas,0,106138
2018-10-17,9,0,0,Todas,0,106147
2018-10-18,22,0,0,Todas,0,106169
2018-10-19,22,0,0,Todas,0,106191
2018-10-20,1,0,0,Todas,0,106192
2018-10-22,25,0,0,Todas,0,106217
2018-10-23,20,0,0,Todas,0,106237
2018-10-24,21,0,0,Todas,0,106258
2018-10-25,22,0,0,Todas,0,106280
2018-10-26,27,0,0,Todas,0,106307
2018-10-28,1,0,0,Todas,0,106308
2018-10-29,16,0,0,Todas,0,106324
2018-10-30,23,0,0,Todas,0,106347
2018-10-31,28,0,0,Todas,0,106375
2018-11-05,17,0,0,Todas,0,106392
2018-11-06,27,0,0,Todas,0,106419
2018-11-07,21,0,0,Todas,0,106440
2018-11-08,21,0,0,Todas,0,106461
2018-11-09,17,0,0,Todas,0,106478
2018-11-10,1,0,0,Todas,0,106479
2018-11-11,1,0,0,Todas,0,106480
2018-11-12,23,0,0,Todas,0,106503
2018-11-13,30,0,0,Todas,0,106533
2018-11-14,23,0,0,Todas,0,106556
2018-11-15,19,0,0,Todas,0,106575
2018-11-16,36,0,0,Todas,0,106611
2018-11-19,18,0,0,Todas,0,106629
2018-11-20,22,0,0,Todas,0,106651
2018-11-21,24,0,0,Todas,0,106675
2018-11-22,16,0,0,Todas,0,106691
2018-11-23,15,0,0,Todas,0,106706
2018-11-26,21,0,0,Todas,0,106727
2018-11-27,18,0,0,Todas,0,106745
2018-11-28,17,0,0,Todas,0,106762
2018-11-29,15,0,0,Todas,0,106777
2018-11-30,19,0,0,Todas,0,106796
2018-12-01,1,0,0,Todas,0,106797
2018-12-02,1,0,0,Todas,0,106798
2018-12-03,24,0,0,Todas,0,106822
2018-12-04,19,0,0,Todas,0,106841
2018-12-05,27,0,0,Todas,0,106868
2018-12-06,18,0,0,Todas,0,106886
2018-12-07,2,0,0,Todas,0,106888
2018-12-10,24,0,0,Todas,0,106912
2018-12-11,23,0,0,Todas,0,106935
2018-12-12,28,0,0,Todas,0,106963
2018-12-13,28,0,0,Todas,0,106991
2018-12-14,18,0,0,Todas,0,107009
2018-12-15,1,0,0,Todas,0,107010
2018-12-17,21,0,0,Todas,0,107031
2018-12-18,16,0,0,Todas,0,107047
2018-12-19,20,0,0,Todas,0,107067
2018-12-20,20,0,0,Todas,0,107087
2018-12-21,16,0,0,Todas,0,107103
2018-12-22,1,0,0,Todas,0,107104
2018-12-26,21,0,0,Todas,0,107125
2018-12-27,20,0,0,Todas,0,107145
2018-12-28,19,0,0,Todas,0,107164
2019-01-01,1,0,0,Todas,0,107165
2019-01-02,15,0,0,Todas,0,107180
2019-01-03,18,0,0,Todas,0,107198
2019-01-04,17,0,0,Todas,0,107215
2019-01-07,18,0,0,Todas,0,107233
2019-01-08,19,0,0,Todas,0,107252
2019-01-09,24,0,0,Todas,0,107276
2019-01-10,20,0,0,Todas,0,107296
2019-01-11,24,0,0,Todas,0,107320
2019-01-14,19,0,0,Todas,0,107339
2019-01-15,21,0,0,Todas,0,107360
2019-01-16,18,0,0,Todas,0,107378
2019-01-17,18,0,0,Todas,0,107396
2019-01-18,25,0,0,Todas,0,107421
2019-01-20,1,0,0,Todas,0,107422
2019-01-21,24,0,0,Todas,0,107446
2019-01-22,19,0,0,Todas,0,107465
2019-01-23,812,0,0,Todas,0,108277
2019-01-24,22,0,0,Todas,0,108299
2019-01-25,25,0,0,Todas,0,108324
2019-01-28,25,0,0,Todas,0,108349
2019-01-29,31,0,0,Todas,0,108380
2019-01-30,24,0,0,Todas,0,108404
2019-01-31,55,0,0,Todas,0,108459
2019-02-01,107,0,0,Todas,0,108566
2019-02-04,28,0,0,Todas,0,108594
2019-02-05,22,0,0,Todas,0,108616
2019-02-06,26,0,0,Todas,0,108642
2019-02-07,32,0,0,Todas,0,108674
2019-02-08,48,0,0,Todas,0,108722
2019-02-09,1,0,0,Todas,0,108723
2019-02-11,20,0,0,Todas,0,108743
2019-02-12,33,0,0,Todas,0,108776
2019-02-13,27,0,0,Todas,0,108803
2019-02-14,22,0,0,Todas,0,108825
2019-02-15,21,0,0,Todas,0,108846
2019-02-18,19,0,0,Todas,0,108865
2019-02-19,23,0,0,Todas,0,108888
2019-02-20,27,0,0,Todas,0,108915
2019-02-21,27,0,0,Todas,0,108942
2019-02-22,16,0,0,Todas,0,108958
2019-02-25,23,0,0,Todas,0,108981
2019-02-26,21,0,0,Todas,0,109002
2019-02-27,19,0,0,Todas,0,109021
2019-02-28,18,0,0,Todas,0,109039
2019-03-01,28,0,0,Todas,0,109067
2019-03-02,1,0,0,Todas,0,109068
2019-03-06,16,0,0,Todas,0,109084
2019-03-07,25,0,0,Todas,0,109109
2019-03-08,21,0,0,Todas,0,109130
2019-03-11,22,0,0,Todas,0,109152
2019-03-12,16,0,0,Todas,0,109168
2019-03-13,12,0,0,Todas,0,109180
2019-03-14,18,0,0,Todas,0,109198
2019-03-15,23,0,0,Todas,0,109221
2019-03-16,1,0,0,Todas,0,109222
2019-03-18,16,0,0,Todas,0,109238
2019-03-19,21,0,0,Todas,0,109259
2019-03-20,26,0,0,Todas,0,109285
2019-03-21,26,0,0,Todas,0,109311
2019-03-22,33,0,0,Todas,0,109344
2019-03-24,1,0,0,Todas,0,109345
2019-03-25,19,0,0,Todas,0,109364
2019-03-26,17,0,0,Todas,0,109381
2019-03-27,25,0,0,Todas,0,109406
2019-03-28,23,0,0,Todas,0,109429
2019-03-29,17,0,0,Todas,0,109446
2019-04-01,19,0,0,Todas,0,109465
2019-04-02,23,0,0,Todas,0,109488
2019-04-03,22,0,0,Todas,0,109510
2019-04-04,31,0,0,Todas,0,109541
2019-04-05,23,0,0,Todas,0,109564
2019-04-08,22,0,0,Todas,0,109586
2019-04-09,22,0,0,Todas,0,109608
2019-04-10,19,0,0,Todas,0,109627
2019-04-11,15,0,0,Todas,0,109642
2019-04-12,15,0,0,Todas,0,109657
2019-04-15,19,0,0,Todas,0,109676
2019-04-16,23,0,0,Todas,0,109699
2019-04-17,16,0,0,Todas,0,109715
2019-04-18,25,0,0,Todas,0,109740
2019-04-22,16,0,0,Todas,0,109756
2019-04-23,29,0,0,Todas,0,109785
2019-04-24,19,0,0,Todas,0,109804
2019-04-25,21,0,0,Todas,0,109825
2019-04-26,22,0,0,Todas,0,109847
2019-04-29,13,0,0,Todas,0,109860
2019-04-30,14,0,0,Todas,0,109874
2019-05-01,1,0,0,Todas,0,109875
2019-05-02,18,0,0,Todas,0,109893
2019-05-06,25,0,0,Todas,0,109918
2019-05-07,31,0,0,Todas,0,109949
2019-05-08,26,0,0,Todas,0,109975
2019-05-09,21,0,0,Todas,0,109996
2019-05-10,24,0,0,Todas,0,110020
2019-05-13,22,0,0,Todas,0,110042
2019-05-14,32,0,0,Todas,0,110074
2019-05-15,30,0,0,Todas,0,110104
2019-05-16,26,0,0,Todas,0,110130
2019-05-17,31,0,0,Todas,0,110161
2019-05-20,29,0,0,Todas,0,110190
2019-05-21,14,0,0,Todas,0,110204
2019-05-22,21,0,0,Todas,0,110225
2019-05-23,43,0,0,Todas,0,110268
2019-05-27,15,0,0,Todas,0,110283
2019-05-28,21,0,0,Todas,0,110304
2019-05-29,23,0,0,Todas,0,110327
2019-05-30,23,0,0,Todas,0,110350
2019-05-31,28,0,0,Todas,0,110378
2019-06-03,12,0,0,Todas,0,110390
2019-06-04,13,0,0,Todas,0,110403
2019-06-05,19,0,0,Todas,0,110422
2019-06-06,21,0,0,Todas,0,110443
2019-06-07,36,0,0,Todas,0,110479
2019-06-10,32,0,0,Todas,0,110511
2019-06-11,25,0,0,Todas,0,110536
2019-06-12,25,0,0,Todas,0,110561
2019-06-13,20,0,0,Todas,0,110581
2019-06-14,19,0,0,Todas,0,110600
2019-06-17,28,0,0,Todas,0,110628
2019-06-18,35,0,0,Todas,0,110663
2019-06-19,24,0,0,Todas,0,110687
2019-06-20,21,0,0,Todas,0,110708
2019-06-21,19,0,0,Todas,0,110727
2019-06-24,18,0,0,Todas,0,110745
2019-06-25,21,0,0,Todas,0,110766
2019-06-26,28,0,0,Todas,0,110794
2019-06-27,32,0,0,Todas,0,110826
2019-06-28,18,0,0,Todas,0,110844
2019-07-01,28,0,0,Todas,0,110872
2019-07-02,19,0,0,Todas,0,110891
2019-07-03,22,0,0,Todas,0,110913
2019-07-04,20,0,0,Todas,0,110933
2019-07-05,35,0,0,Todas,0,110968
2019-07-08,30,0,0,Todas,0,110998
2019-07-09,13,0,0,Todas,0,111011
2019-07-10,21,0,0,Todas,0,111032
2019-07-11,19,0,0,Todas,0,111051
2019-07-12,21,0,0,Todas,0,111072
2019-07-15,26,0,0,Todas,0,111098
2019-07-16,27,0,0,Todas,0,111125
2019-07-17,25,0,0,Todas,0,111150
2019-07-18,30,0,0,Todas,0,111180
2019-07-19,23,0,0,Todas,0,111203
2019-07-22,22,0,0,Todas,0,111225
2019-07-23,19,0,0,Todas,0,111244
2019-07-24,16,0,0,Todas,0,111260
2019-07-25,17,0,0,Todas,0,111277
2019-07-26,25,0,0,Todas,0,111302
2019-07-29,16,0,0,Todas,0,111318
2019-07-30,11,0,0,Todas,0,111329
2019-07-31,22,0,0,Todas,0,111351
2019-08-01,22,0,0,Todas,0,111373
2019-08-02,24,0,0,Todas,0,111397
2019-08-05,17,0,0,Todas,0,111414
2019-08-06,17,0,0,Todas,0,111431
2019-08-07,33,0,0,Todas,0,111464
2019-08-08,21,0,0,Todas,0,111485
2019-08-12,16,0,0,Todas,0,111501
2019-08-13,22,0,0,Todas,0,111523
2019-08-14,22,0,0,Todas,0,111545
2019-08-15,26,0,0,Todas,0,111571
2019-08-16,20,0,0,Todas,0,111591
2019-08-19,18,0,0,Todas,0,111609
2019-08-20,29,0,0,Todas,0,111638
2019-08-21,26,0,0,Todas,0,111664
2019-08-22,21,0,0,Todas,0,111685
2019-08-23,23,0,0,Todas,0,111708
2019-08-25,1,0,0,Todas,0,111709
2019-08-26,15,0,0,Todas,0,111724
2019-08-27,16,0,0,Todas,0,111740
2019-08-28,22,0,0,Todas,0,111762
2019-08-29,31,0,0,Todas,0,111793
2019-08-30,20,0,0,Todas,0,111813
2019-09-01,1,0,0,Todas,0,111814
2019-09-02,14,0,0,Todas,0,111828
2019-09-03,24,0,0,Todas,0,111852
2019-09-04,32,0,0,Todas,0,111884
2019-09-05,19,0,0,Todas,0,111903
2019-09-06,27,0,0,Todas,0,111930
2019-09-09,20,0,0,Todas,0,111950
2019-09-10,15,0,0,Todas,0,111965
2019-09-11,25,0,0,Todas,0,111990
2019-09-12,26,0,0,Todas,0,112016
2019-09-13,22,0,0,Todas,0,112038
2019-09-16,20,0,0,Todas,0,112058
2019-09-17,27,0,0,Todas,0,112085
2019-09-18,15,0,0,Todas,0,112100
2019-09-19,24,0,0,Todas,0,112124
2019-09-20,13,0,0,Todas,0,112137
2019-09-23,15,0,0,Todas,0,112152
2019-09-24,22,0,0,Todas,0,112174
2019-09-25,29,0,0,Todas,0,112203
2019-09-26,27,0,0,Todas,0,112230
2019-09-27,32,0,0,Todas,0,112262
2019-09-30,15,0,0,Todas,0,112277
2019-10-01,18,0,0,Todas,0,112295
2019-10-02,20,0,0,Todas,0,112315
2019-10-03,15,0,0,Todas,0,112330
2019-10-04,19,0,0,Todas,0,112349
2019-10-07,11,0,0,Todas,0,112360
2019-10-08,3,0,0,Todas,0,112363
2019-10-09,4,0,0,Todas,0,112367
2019-10-10,15,0,0,Todas,0,112382
2019-10-14,18,0,0,Todas,0,112400
2019-10-15,21,0,0,Todas,0,112421
2019-10-16,15,0,0,Todas,0,112436
2019-10-17,24,0,0,Todas,0,112460
2019-10-18,26,0,0,Todas,0,112486
2019-10-21,21,0,0,Todas,0,112507
2019-10-22,25,0,0,Todas,0,112532
2019-10-23,19,0,0,Todas,0,112551
2019-10-24,25,0,0,Todas,0,112576
2019-10-25,22,0,0,Todas,0,112598
2019-10-28,23,0,0,Todas,0,112621
2019-10-29,39,0,0,Todas,0,112660
2019-10-30,13,0,0,Todas,0,112673
2019-10-31,26,0,0,Todas,0,112699
2019-11-05,24,0,0,Todas,0,112723
2019-11-06,22,0,0,Todas,0,112745
2019-11-07,30,0,0,Todas,0,112775
2019-11-08,18,0,0,Todas,0,112793
2019-11-11,24,0,0,Todas,0,112817
2019-11-12,25,0,0,Todas,0,112842
2019-11-13,20,0,0,Todas,0,112862
2019-11-14,17,0,0,Todas,0,112879
2019-11-15,16,0,0,Todas,0,112895
2019-11-16,1,0,0,Todas,0,112896
2019-11-18,21,0,0,Todas,0,112917
2019-11-19,25,0,0,Todas,0,112942
2019-11-20,27,0,0,Todas,0,112969
2019-11-21,7,0,0,Todas,0,112976
2019-11-22,29,0,0,Todas,0,113005
2019-11-25,12,0,0,Todas,0,113017
2019-11-26,15,0,0,Todas,0,113032
2019-11-27,24,0,0,Todas,0,113056
2019-11-28,27,0,0,Todas,0,113083
2019-11-29,17,0,0,Todas,0,113100
2019-12-01,1,0,0,Todas,0,113101
2019-12-02,14,0,0,Todas,0,113115
2019-12-03,25,0,0,Todas,0,113140
2019-12-04,20,0,0,Todas,0,113160
2019-12-05,13,0,0,Todas,0,113173
2019-12-06,3,0,0,Todas,0,113176
2019-12-09,14,0,0,Todas,0,113190
2019-12-10,21,0,0,Todas,0,113211
2019-12-11,17,0,0,Todas,0,113228
2019-12-12,13,0,0,Todas,0,113241
2019-12-13,20,0,0,Todas,0,113261
2019-12-15,1,0,0,Todas,0,113262
2019-12-16,20,0,0,Todas,0,113282
2019-12-17,20,0,0,Todas,0,113302
2019-12-18,14,0,0,Todas,0,113316
2019-12-19,26,0,0,Todas,0,113342
2019-12-20,21,0,0,Todas,0,113363
2019-12-23,19,0,0,Todas,0,113382
2019-12-24,17,0,0,Todas,0,113399
2019-12-26,17,0,0,Todas,0,113416
2019-12-27,11,0,0,Todas,0,113427
2020-01-02,22,0,0,Todas,0,113449
2020-01-03,9,0,0,Todas,0,113458
2020-01-04,13,0,0,Todas,0,113471
2020-01-06,14,0,0,Todas,0,113485
2020-01-07,24,0,0,Todas,0,113509
2020-01-08,19,0,0,Todas,0,113528
2020-01-09,18,0,0,Todas,0,113546
2020-01-10,18,0,0,Todas,0,113564
2020-01-11,14,0,0,Todas,0,113578
2020-01-13,25,0,0,Todas,0,113603
2020-01-14,10,0,0,Todas,0,113613
2020-01-15,15,0,0,Todas,0,113628
2020-01-16,24,0,0,Todas,0,113652
2020-01-17,21,0,0,Todas,0,113673
2020-01-20,19,0,0,Todas,0,113692
2020-01-21,21,0,0,Todas,0,113713
2020-01-22,24,0,0,Todas,0,113737
2020-01-23,22,0,0,Todas,0,113759
2020-01-24,21,0,0,Todas,0,113780
2020-01-27,25,0,0,Todas,0,113805
2020-01-28,26,0,0,Todas,0,113831
2020-01-29,26,0,0,Todas,0,113857
2020-01-30,25,0,0,Todas,0,113882
2020-01-31,27,0,0,Todas,0,113909
2020-02-03,34,0,0,Todas,0,113943
2020-02-04,27,0,0,Todas,0,113970
2020-02-05,26,0,0,Todas,0,113996
2020-02-06,22,0,0,Todas,0,114018
2020-02-07,22,0,0,Todas,0,114040
2020-02-10,23,0,0,Todas,0,114063
2020-02-11,26,0,0,Todas,0,114089
2020-02-12,32,0,0,Todas,0,114121
2020-02-13,21,0,0,Todas,0,114142
2020-02-14,24,0,0,Todas,0,114166
2020-02-17,22,0,0,Todas,0,114188
2020-02-18,31,0,0,Todas,0,114219
2020-02-19,26,0,0,Todas,0,114245
2020-02-20,32,0,0,Todas,0,114277
2020-02-21,17,0,0,Todas,0,114294
2020-02-26,18,0,0,Todas,0,114312
2020-02-27,22,0,0,Todas,0,114334
2020-02-28,19,0,0,Todas,0,114353
2020-03-01,1,0,0,Todas,0,114354
2020-03-02,12,0,0,Todas,0,114366
2020-03-03,18,0,0,Todas,0,114384
2020-03-04,15,0,0,Todas,0,114399
2020-03-05,18,0,0,Todas,0,114417
2020-03-06,21,0,0,Todas,0,114438
2020-03-09,24,0,0,Todas,0,114462
2020-03-10,24,0,0,Todas,0,114486
2020-03-11,26,0,0,Todas,0,114512
2020-03-12,23,0,0,Todas,0,114535
2020-03-13,35,0,0,Todas,0,114570
2020-03-16,4,0,0,Todas,0,114574
2020-03-18,9,0,0,Todas,0,114583
2020-03-19,1,0,0,Todas,0,114584
2020-03-20,1,0,0,Todas,0,114585
2020-03-23,1,0,0,Todas,0,114586
2020-04-04,2,0,0,Todas,0,114588
2020-04-09,1,0,0,Todas,0,114589
2020-04-17,3,0,0,Todas,0,114592
2020-04-20,1,0,0,Todas,0,114593
2020-04-22,1,0,0,Todas,0,114594
2020-04-28,2,0,0,Todas,0,114596
2020-04-29,1,0,0,Todas,0,114597
2020-04-30,1,0,0,Todas,0,114598
2020-05-01,1,0,0,Todas,0,114599
2020-05-05,2,0,0,Todas,0,114601
2020-05-06,1,0,0,Todas,0,114602
2020-05-08,1,0,0,Todas,0,114603
2020-05-11,4,0,0,Todas,0,114607
2020-05-12,5,0,0,Todas,0,114612
2020-05-13,5,0,0,Todas,0,114617
2020-05-14,9,0,0,Todas,0,114626
2020-05-15,8,0,0,Todas,0,114634
2020-05-16,1,0,0,Todas,0,114635
2020-05-18,11,0,0,Todas,0,114646
2020-05-19,10,0,0,Todas,0,114656
2020-05-20,16,0,0,Todas,0,114672
2020-05-21,12,0,0,Todas,0,114684
2020-05-22,8,0,0,Todas,0,114692
2020-05-25,4,0,0,Todas,0,114696
2020-05-26,13,0,0,Todas,0,114709
2020-05-27,10,0,0,Todas,0,114719
2020-05-28,14,0,0,Todas,0,114733
2020-05-29,6,0,0,Todas,0,114739
2020-06-01,13,0,0,Todas,0,114752
2020-06-02,5,0,0,Todas,0,114757
2020-06-03,6,0,0,Todas,0,114763
2020-06-04,7,0,0,Todas,0,114770
2020-06-05,8,0,0,Todas,0,114778
2020-06-08,5,0,0,Todas,0,114783
2020-06-09,12,0,0,Todas,0,114795
2020-06-10,11,0,0,Todas,0,114806
2020-06-11,7,0,0,Todas,0,114813
2020-06-12,10,0,0,Todas,0,114823
2020-06-15,13,0,0,Todas,0,114836
2020-06-16,8,0,0,Todas,0,114844
2020-06-17,11,0,0,Todas,0,114855
2020-06-18,10,0,0,Todas,0,114865
2020-06-19,14,0,0,Todas,0,114879
2020-06-22,14,0,0,Todas,0,114893
2020-06-23,15,0,0,Todas,0,114908
2020-06-24,10,0,0,Todas,0,114918
2020-06-25,9,0,0,Todas,0,114927
2020-06-26,9,0,0,Todas,0,114936
2020-06-28,2,0,0,Todas,0,114938
2020-06-29,9,0,0,Todas,0,114947
2020-06-30,7,0,0,Todas,0,114954
2020-07-01,16,0,0,Todas,0,114970
2020-07-02,14,0,0,Todas,0,114984
2020-07-03,10,0,0,Todas,0,114994
2020-07-06,18,0,0,Todas,0,115012
2020-07-07,12,0,0,Todas,0,115024
2020-07-08,16,0,0,Todas,0,115040
2020-07-09,13,0,0,Todas,0,115053
2020-07-10,18,0,0,Todas,0,115071
2020-07-13,19,0,0,Todas,0,115090
2020-07-14,19,0,0,Todas,0,115109
2020-07-15,27,0,0,Todas,0,115136
2020-07-16,15,0,0,Todas,0,115151
2020-07-17,20,0,0,Todas,0,115171
2020-07-19,1,0,0,Todas,0,115172
2020-07-20,17,0,0,Todas,0,115189
2020-07-21,13,0,0,Todas,0,115202
2020-07-22,9,0,0,Todas,0,115211
2020-07-23,16,0,0,Todas,0,115227
2020-07-24,8,0,0,Todas,0,115235
2020-07-27,22,0,0,Todas,0,115257
2020-07-28,19,0,0,Todas,0,115276
2020-07-29,15,0,0,Todas,0,115291
2020-07-30,14,0,0,Todas,0,115305
2020-07-31,8,0,0,Todas,0,115313
2020-08-01,4,0,0,Todas,0,115317
2020-08-03,21,0,0,Todas,0,115338
2020-08-04,15,0,0,Todas,0,115353
2020-08-05,20,0,0,Todas,0,115373
2020-08-06,16,0,0,Todas,0,115389
2020-08-07,18,0,0,Todas,0,115407
2020-08-11,16,0,0,Todas,0,115423
2020-08-12,23,0,0,Todas,0,115446
2020-08-13,15,0,0,Todas,0,115461
2020-08-14,18,0,0,Todas,0,115479
2020-08-17,27,0,0,Todas,0,115506
2020-08-18,19,0,0,Todas,0,115525
2020-08-19,15,0,0,Todas,0,115540
2020-08-20,25,0,0,Todas,0,115565
2020-08-21,22,0,0,Todas,0,115587
2020-08-24,28,0,0,Todas,0,115615
2020-08-25,20,0,0,Todas,0,115635
2020-08-26,21,0,0,Todas,0,115656
2020-08-27,16,0,0,Todas,0,115672
2020-08-28,9,0,0,Todas,0,115681
2020-08-29,2,0,0,Todas,0,115683
2020-08-31,19,0,0,Todas,0,115702
2020-09-01,15,0,0,Todas,0,115717
2020-09-02,18,0,0,Todas,0,115735
2020-09-03,6,0,0,Todas,0,115741
2020-09-04,23,0,0,Todas,0,115764
2020-09-05,4,0,0,Todas,0,115768
2020-09-07,16,0,0,Todas,0,115784
2020-09-08,20,0,0,Todas,0,115804
2020-09-09,26,0,0,Todas,0,115830
2020-09-10,18,0,0,Todas,0,115848
2020-09-11,22,0,0,Todas,0,115870
2020-09-13,1,0,0,Todas,0,115871
2020-09-14,19,0,0,Todas,0,115890
2020-09-15,17,0,0,Todas,0,115907
2020-09-16,23,0,0,Todas,0,115930
2020-09-17,25,0,0,Todas,0,115955
2020-09-18,20,0,0,Todas,0,115975
2020-09-20,1,0,0,Todas,0,115976
2020-09-21,16,0,0,Todas,0,115992
2020-09-22,16,0,0,Todas,0,116008
2020-09-23,10,0,0,Todas,0,116018
2020-09-24,18,0,0,Todas,0,116036
2020-09-25,21,0,0,Todas,0,116057
2020-09-28,22,0,0,Todas,0,116079
2020-09-29,24,0,0,Todas,0,116103
2020-09-30,17,0,0,Todas,0,116120
2020-10-01,16,0,0,Todas,0,116136
2020-10-02,17,0,0,Todas,0,116153
2020-10-03,1,0,0,Todas,0,116154
2020-10-05,14,0,0,Todas,0,116168
2020-10-06,18,0,0,Todas,0,116186
2020-10-07,29,0,0,Todas,0,116215
2020-10-08,18,0,0,Todas,0,116233
2020-10-09,2,0,0,Todas,0,116235
2020-10-10,1,0,0,Todas,0,116236
2020-10-11,1,0,0,Todas,0,116237
2020-10-12,19,0,0,Todas,0,116256
2020-10-13,29,0,0,Todas,0,116285
2020-10-14,23,0,0,Todas,0,116308
2020-10-15,27,0,0,Todas,0,116335
2020-10-16,21,0,0,Todas,0,116356
2020-10-17,1,0,0,Todas,0,116357
2020-10-18,2,0,0,Todas,0,116359
2020-10-19,23,0,0,Todas,0,116382
2020-10-20,24,0,0,Todas,0,116406
2020-10-21,24,0,0,Todas,0,116430
2020-10-22,21,0,0,Todas,0,116451
2020-10-23,21,0,0,Todas,0,116472
2020-10-24,1,0,0,Todas,0,116473
2020-10-26,22,0,0,Todas,0,116495
2020-10-27,18,0,0,Todas,0,116513
2020-10-28,23,0,0,Todas,0,116536
2020-10-29,34,0,0,Todas,0,116570
2020-10-30,39,0,0,Todas,0,116609
2020-11-01,2,0,0,Todas,0,116611
2020-11-02,1,0,0,Todas,0,116612
2020-11-03,3,0,0,Todas,0,116615
2020-11-04,24,0,0,Todas,0,116639
2020-11-05,21,0,0,Todas,0,116660
2020-11-06,32,0,0,Todas,0,116692
2020-11-09,19,0,0,Todas,0,116711
2020-11-10,26,0,0,Todas,0,116737
2020-11-11,31,0,0,Todas,0,116768
2020-11-12,20,0,0,Todas,0,116788
2020-11-13,28,0,0,Todas,0,116816
2020-11-14,1,0,0,Todas,0,116817
2020-11-16,30,0,0,Todas,0,116847
2020-11-17,29,0,0,Todas,0,116876
2020-11-18,19,0,0,Todas,0,116895
2020-11-19,26,0,0,Todas,0,116921
2020-11-20,24,0,0,Todas,0,116945
2020-11-21,1,0,0,Todas,0,116946
2020-11-22,1,0,0,Todas,0,116947
2020-11-23,26,0,0,Todas,0,116973
2020-11-24,24,0,0,Todas,0,116997
2020-11-25,22,0,0,Todas,0,117019
2020-11-26,26,0,0,Todas,0,117045
2020-11-27,22,0,0,Todas,0,117067
2020-11-30,18,0,0,Todas,0,117085
2020-12-01,41,0,0,Todas,0,117126
2020-12-02,32,0,0,Todas,0,117158
2020-12-03,29,0,0,Todas,0,117187
2020-12-04,22,0,0,Todas,0,117209
2020-12-05,1,0,0,Todas,0,117210
2020-12-06,1,0,0,Todas,0,117211
2020-12-07,3,0,0,Todas,0,117214
2020-12-08,28,0,0,Todas,0,117242
2020-12-09,27,0,0,Todas,0,117269
2020-12-10,26,0,0,Todas,0,117295
2020-12-11,18,0,0,Todas,0,117313
2020-12-14,31,0,0,Todas,0,117344
2020-12-15,21,0,0,Todas,0,117365
2020-12-16,33,0,0,Todas,0,117398
2020-12-17,32,0,0,Todas,0,117430
2020-12-18,31,0,0,Todas,0,117461
2020-12-19,1,0,0,Todas,0,117462
2020-12-20,1,0,0,Todas,0,117463
2020-12-21,24,0,0,Todas,0,117487
2020-12-22,22,0,0,Todas,0,117509
2020-12-23,39,0,0,Todas,0,117548
2020-12-24,4,0,0,Todas,0,117552
2020-12-25,1,0,0,Todas,0,117553
2020-12-28,4,0,0,Todas,0,117557
2020-12-29,2,0,0,Todas,0,117559
2020-12-30,3,0,0,Todas,0,117562
2020-12-31,2,0,0,Todas,0,117564
2021-01-01,2,0,0,Todas,0,117566
2021-01-02,1,0,0,Todas,0,117567
2021-01-04,24,0,0,Todas,0,117591
2021-01-05,21,0,0,Todas,0,117612
2021-01-06,36,0,0,Todas,0,117648
2021-01-07,21,0,0,Todas,0,117669
2021-01-08,26,0,0,Todas,0,117695
2021-01-09,3,0,0,Todas,0,117698
2021-01-11,30,0,0,Todas,0,117728
2021-01-12,35,0,0,Todas,0,117763
2021-01-13,42,0,0,Todas,0,117805
2021-01-14,24,0,0,Todas,0,117829
2021-01-15,26,0,0,Todas,0,117855
2021-01-16,1,0,0,Todas,0,117856
2021-01-17,1,0,0,Todas,0,117857
2021-01-18,30,0,0,Todas,0,117887
2021-01-19,27,0,0,Todas,0,117914
2021-01-20,40,0,0,Todas,0,117954
2021-01-21,25,0,0,Todas,0,117979
2021-01-22,29,0,0,Todas,0,118008
2021-01-23,1,0,0,Todas,0,118009
2021-01-24,2,0,0,Todas,0,118011
2021-01-25,32,0,0,Todas,0,118043
2021-01-26,39,0,0,Todas,0,118082
2021-01-27,26,0,0,Todas,0,118108
2021-01-28,21,0,0,Todas,0,118129
2021-01-29,29,0,0,Todas,0,118158
2021-02-01,22,0,0,Todas,0,118180
2021-02-02,34,0,0,Todas,0,118214
2021-02-03,29,0,0,Todas,0,118243
2021-02-04,37,0,0,Todas,0,118280
2021-02-05,28,0,0,Todas,0,118308
2021-02-08,24,0,0,Todas,0,118332
2021-02-09,22,0,0,Todas,0,118354
2021-02-10,24,0,0,Todas,0,118378
2021-02-11,17,0,0,Todas,0,118395
2021-02-12,16,0,0,Todas,0,118411
2021-02-14,1,0,0,Todas,0,118412
2021-02-15,5,0,0,Todas,0,118417
2021-02-16,2,0,0,Todas,0,118419
2021-02-17,35,0,0,Todas,0,118454
2021-02-18,22,0,0,Todas,0,118476
2021-02-19,25,0,0,Todas,0,118501
2021-02-20,3,0,0,Todas,0,118504
2021-02-21,2,0,0,Todas,0,118506
2021-02-22,33,0,0,Todas,0,118539
2021-02-23,24,0,0,Todas,0,118563
2021-02-24,25,0,0,Todas,0,118588
2021-02-25,25,0,0,Todas,0,118613
2021-02-26,23,0,0,Todas,0,118636
2021-02-27,2,0,0,Todas,0,118638
2021-02-28,1,0,0,Todas,0,118639
2021-03-01,42,0,0,Todas,0,118681
2021-03-02,21,0,0,Todas,0,118702
2021-03-03,28,0,0,Todas,0,118730
2021-03-04,23,0,0,Todas,0,118753
2021-03-05,21,0,0,Todas,0,118774
2021-03-08,19,0,0,Todas,0,118793
2021-03-09,24,0,0,Todas,0,118817
2021-03-10,38,0,0,Todas,0,118855
2021-03-11,33,0,0,Todas,0,118888
2021-03-12,35,0,0,Todas,0,118923
2021-03-13,1,0,0,Todas,0,118924
2021-03-14,1,0,0,Todas,0,118925
2021-03-15,24,0,0,Todas,0,118949
2021-03-16,22,0,0,Todas,0,118971
2021-03-17,20,0,0,Todas,0,118991
2021-03-18,30,0,0,Todas,0,119021
2021-03-19,26,0,0,Todas,0,119047
2021-03-22,20,0,0,Todas,0,119067
2021-03-23,17,0,0,Todas,0,119084
2021-03-24,15,0,0,Todas,0,119099
2021-03-25,33,0,0,Todas,0,119132
2021-03-26,24,0,0,Todas,0,119156
2021-03-28,1,0,0,Todas,0,119157
2021-03-29,21,0,0,Todas,0,119178
2021-03-30,23,0,0,Todas,0,119201
2021-03-31,20,0,0,Todas,0,119221
2021-04-01,19,0,0,Todas,0,119240
2021-04-03,1,0,0,Todas,0,119241
2021-04-04,1,0,0,Todas,0,119242
2021-04-05,9,0,0,Todas,0,119251
2021-04-06,16,0,0,Todas,0,119267
2021-04-07,17,0,0,Todas,0,119284
2021-04-08,19,0,0,Todas,0,119303
2021-04-09,13,0,0,Todas,0,119316
2021-04-12,18,0,0,Todas,0,119334
2021-04-13,19,0,0,Todas,0,119353
2021-04-14,18,0,0,Todas,0,119371
2021-04-15,18,0,0,Todas,0,119389
2021-04-16,28,0,0,Todas,0,119417
2021-04-17,1,0,0,Todas,0,119418
2021-04-18,3,0,0,Todas,0,119421
2021-04-19,27,0,0,Todas,0,119448
2021-04-20,26,0,0,Todas,0,119474
2021-04-21,23,0,0,Todas,0,119497
2021-04-22,29,0,0,Todas,0,119526
2021-04-23,25,0,0,Todas,0,119551
2021-04-24,4,0,0,Todas,0,119555
2021-04-26,21,0,0,Todas,0,119576
2021-04-27,13,0,0,Todas,0,119589
2021-04-28,40,0,0,Todas,0,119629
2021-04-29,32,0,0,Todas,0,119661
2021-04-30,1,0,0,Todas,0,119662
2021-05-01,4,0,0,Todas,0,119666
2021-05-02,3,0,0,Todas,0,119669
2021-05-03,29,0,0,Todas,0,119698
2021-05-04,31,0,0,Todas,0,119729
2021-05-05,29,0,0,Todas,0,119758
2021-05-06,24,0,0,Todas,0,119782
2021-05-07,23,0,0,Todas,0,119805
2021-05-08,5,0,0,Todas,0,119810
2021-05-09,1,0,0,Todas,0,119811
2021-05-10,25,0,0,Todas,0,119836
2021-05-11,27,0,0,Todas,0,119863
2021-05-12,16,0,0,Todas,0,119879
2021-05-13,21,0,0,Todas,0,119900
2021-05-14,17,0,0,Todas,0,119917
2021-05-15,4,0,0,Todas,0,119921
2021-05-16,6,0,0,Todas,0,119927
2021-05-17,23,0,0,Todas,0,119950
2021-05-18,16,0,0,Todas,0,119966
2021-05-19,23,0,0,Todas,0,119989
2021-05-20,27,0,0,Todas,0,120016
2021-05-21,28,0,0,Todas,0,120044
2021-05-22,4,0,0,Todas,0,120048
2021-05-23,1,0,0,Todas,0,120049
2021-05-24,4,0,0,Todas,0,120053
2021-05-25,26,0,0,Todas,0,120079
2021-05-26,38,0,0,Todas,0,120117
2021-05-27,31,0,0,Todas,0,120148
2021-05-28,29,0,0,Todas,0,120177
2021-05-29,1,0,0,Todas,0,120178
2021-05-30,2,0,0,Todas,0,120180
2021-05-31,22,0,0,Todas,0,120202
2021-06-01,31,0,0,Todas,0,120233
2021-06-02,29,0,0,Todas,0,120262
2021-06-03,32,0,0,Todas,0,120294
2021-06-04,59,0,0,Todas,0,120353
2021-06-05,3,0,0,Todas,0,120356
2021-06-06,5,0,0,Todas,0,120361
2021-06-07,31,0,0,Todas,0,120392
2021-06-08,19,0,0,Todas,0,120411
2021-06-09,25,0,0,Todas,0,120436
2021-06-10,38,0,0,Todas,0,120474
2021-06-11,56,0,0,Todas,0,120530
2021-06-12,2,0,0,Todas,0,120532
2021-06-13,2,0,0,Todas,0,120534
2021-06-14,29,0,0,Todas,0,120563
2021-06-15,36,0,0,Todas,0,120599
2021-06-16,47,0,0,Todas,0,120646
2021-06-17,31,0,0,Todas,0,120677
2021-06-18,31,0,0,Todas,0,120708
2021-06-19,3,0,0,Todas,0,120711
2021-06-20,4,0,0,Todas,0,120715
2021-06-21,32,0,0,Todas,0,120747
2021-06-22,30,0,0,Todas,0,120777
2021-06-23,37,0,0,Todas,0,120814
2021-06-24,41,0,0,Todas,0,120855
2021-06-25,35,0,0,Todas,0,120890
2021-06-26,4,0,0,Todas,0,120894
2021-06-27,2,0,0,Todas,0,120896
2021-06-28,39,0,0,Todas,0,120935
2021-06-29,27,0,0,Todas,0,120962
2021-06-30,30,0,0,Todas,0,120992
2021-07-01,25,0,0,Todas,0,121017
2021-07-02,70,0,0,Todas,0,121087
2021-07-04,1,0,0,Todas,0,121088
2021-07-05,42,0,0,Todas,0,121130
2021-07-06,40,0,0,Todas,0,121170
2021-07-07,49,0,0,Todas,0,121219
2021-07-08,35,0,0,Todas,0,121254
2021-07-09,41,0,0,Todas,0,121295
2021-07-11,3,0,0,Todas,0,121298
2021-07-12,40,0,0,Todas,0,121338
2021-07-13,32,0,0,Todas,0,121370
2021-07-14,43,0,0,Todas,0,121413
2021-07-15,32,0,0,Todas,0,121445
2021-07-16,30,0,0,Todas,0,121475
2021-07-17,2,0,0,Todas,0,121477
2021-07-18,5,0,0,Todas,0,121482
2021-07-19,29,0,0,Todas,0,121511
2021-07-20,30,0,0,Todas,0,121541
2021-07-21,24,0,0,Todas,0,121565
2021-07-22,38,0,0,Todas,0,121603
2021-07-23,52,0,0,Todas,0,121655
2021-07-24,1,0,0,Todas,0,121656
2021-07-26,29,0,0,Todas,0,121685
2021-07-27,35,0,0,Todas,0,121720
2021-07-28,38,0,0,Todas,0,121758
2021-07-29,30,0,0,Todas,0,121788
2021-07-30,32,0,0,Todas,0,121820
2021-07-31,3,0,0,Todas,0,121823
2021-08-01,4,0,0,Todas,0,121827
2021-08-02,36,0,0,Todas,0,121863
2021-08-03,29,0,0,Todas,0,121892
2021-08-04,28,0,0,Todas,0,121920
2021-08-05,20,0,0,Todas,0,121940
2021-08-06,22,0,0,Todas,0,121962
2021-08-08,1,0,0,Todas,0,121963
2021-08-09,2,0,0,Todas,0,121965
2021-08-10,24,0,0,Todas,0,121989
2021-08-11,25,0,0,Todas,0,122014
2021-08-12,32,0,0,Todas,0,122046
2021-08-13,27,0,0,Todas,0,122073
2021-08-14,4,0,0,Todas,0,122077
2021-08-15,5,0,0,Todas,0,122082
2021-08-16,28,0,0,Todas,0,122110
2021-08-17,30,0,0,Todas,0,122140
2021-08-18,35,0,0,Todas,0,122175
2021-08-19,31,0,0,Todas,0,122206
2021-08-20,33,0,0,Todas,0,122239
2021-08-21,1,0,0,Todas,0,122240
2021-08-22,1,0,0,Todas,0,122241
2021-08-23,28,0,0,Todas,0,122269
2021-08-24,32,0,0,Todas,0,122301
2021-08-25,33,0,0,Todas,0,122334
2021-08-26,37,0,0,Todas,0,122371
2021-08-27,35,0,0,Todas,0,122406
2021-08-28,2,0,0,Todas,0,122408
2021-08-29,1,0,0,Todas,0,122409
2021-08-30,30,0,0,Todas,0,122439
2021-08-31,28,0,0,Todas,0,122467
2021-09-01,46,0,0,Todas,0,122513
2021-09-02,33,0,0,Todas,0,122546
2021-09-03,38,0,0,Todas,0,122584
2021-09-04,2,0,0,Todas,0,122586
2021-09-05,3,0,0,Todas,0,122589
2021-09-06,33,0,0,Todas,0,122622
2021-09-07,34,0,0,Todas,0,122656
2021-09-08,32,0,0,Todas,0,122688
2021-09-09,26,0,0,Todas,0,122714
2021-09-10,27,0,0,Todas,0,122741
2021-09-11,3,0,0,Todas,0,122744
2021-09-12,2,0,0,Todas,0,122746
2021-09-13,29,0,0,Todas,0,122775
2021-09-14,39,0,0,Todas,0,122814
2021-09-15,40,0,0,Todas,0,122854
2021-09-16,28,0,0,Todas,0,122882
2021-09-17,39,0,0,Todas,0,122921
2021-09-18,1,0,0,Todas,0,122922
2021-09-19,4,0,0,Todas,0,122926
2021-09-20,31,0,0,Todas,0,122957
2021-09-21,30,0,0,Todas,0,122987
2021-09-22,27,0,0,Todas,0,123014
2021-09-23,36,0,0,Todas,0,123050
2021-09-24,31,0,0,Todas,0,123081
2021-09-25,1,0,0,Todas,0,123082
2021-09-26,2,0,0,Todas,0,123084
2021-09-27,21,0,0,Todas,0,123105
2021-09-28,33,0,0,Todas,0,123138
2021-09-29,38,0,0,Todas,0,123176
2021-09-30,29,0,0,Todas,0,123205
2021-10-01,31,0,0,Todas,0,123236
2021-10-02,7,0,0,Todas,0,123243
2021-10-03,4,0,0,Todas,0,123247
2021-10-04,34,0,0,Todas,0,123281
2021-10-05,38,0,0,Todas,0,123319
2021-10-06,26,0,0,Todas,0,123345
2021-10-07,40,0,0,Todas,0,123385
2021-10-08,1,0,0,Todas,0,123386
2021-10-09,3,0,0,Todas,0,123389
2021-10-10,1,0,0,Todas,0,123390
2021-10-11,26,0,0,Todas,0,123416
2021-10-12,34,0,0,Todas,0,123450
2021-10-13,32,0,0,Todas,0,123482
2021-10-14,35,0,0,Todas,0,123517
2021-10-15,45,0,0,Todas,0,123562
2021-10-16,7,0,0,Todas,0,123569
2021-10-17,2,0,0,Todas,0,123571
2021-10-18,36,0,0,Todas,0,123607
2021-10-19,38,0,0,Todas,0,123645
2021-10-20,33,0,0,Todas,0,123678
2021-10-21,32,0,0,Todas,0,123710
2021-10-22,27,0,0,Todas,0,123737
2021-10-23,1,0,0,Todas,0,123738
2021-10-24,4,0,0,Todas,0,123742
2021-10-25,33,0,0,Todas,0,123775
2021-10-26,30,0,0,Todas,0,123805
2021-10-27,22,0,0,Todas,0,123827
2021-10-28,31,0,0,Todas,0,123858
2021-10-29,33,0,0,Todas,0,123891
2021-10-30,2,0,0,Todas,0,123893
2021-10-31,1,0,0,Todas,0,123894
2021-11-02,1,0,0,Todas,0,123895
2021-11-03,1,0,0,Todas,0,123896
2021-11-04,40,0,0,Todas,0,123936
2021-11-05,32,0,0,Todas,0,123968
2021-11-06,2,0,0,Todas,0,123970
2021-11-08,31,0,0,Todas,0,124001
2021-11-09,27,0,0,Todas,0,124028
2021-11-10,30,0,0,Todas,0,124058
2021-11-11,33,0,0,Todas,0,124091
2021-11-12,31,0,0,Todas,0,124122
2021-11-13,4,0,0,Todas,0,124126
2021-11-14,13,0,0,Todas,0,124139
2021-11-15,32,0,0,Todas,0,124171
2021-11-16,27,0,0,Todas,0,124198
2021-11-17,22,0,0,Todas,0,124220
2021-11-18,22,0,0,Todas,0,124242
2021-11-19,26,0,0,Todas,0,124268
2021-11-20,3,0,0,Todas,0,124271
2021-11-21,3,0,0,Todas,0,124274
2021-11-22,30,0,0,Todas,0,124304
2021-11-23,34,0,0,Todas,0,124338
2021-11-24,21,0,0,Todas,0,124359
2021-11-25,35,0,0,Todas,0,124394
2021-11-26,28,0,0,Todas,0,124422
2021-11-27,1,0,0,Todas,0,124423
2021-11-28,1,0,0,Todas,0,124424
2021-11-29,25,0,0,Todas,0,124449
2021-11-30,29,0,0,Todas,0,124478
2021-12-01,34,0,0,Todas,0,124512
2021-12-02,32,0,0,Todas,0,124544
2021-12-03,21,0,0,Todas,0,124565
2021-12-06,4,0,0,Todas,0,124569
2021-12-07,23,0,0,Todas,0,124592
2021-12-08,26,0,0,Todas,0,124618
2021-12-09,12,0,0,Todas,0,124630
2021-12-10,29,0,0,Todas,0,124659
2021-12-11,6,0,0,Todas,0,124665
2021-12-12,3,0,0,Todas,0,124668
2021-12-13,36,0,0,Todas,0,124704
2021-12-14,46,0,0,Todas,0,124750
2021-12-15,33,0,0,Todas,0,124783
2021-12-16,39,0,0,Todas,0,124822
2021-12-17,32,0,0,Todas,0,124854
2021-12-18,3,0,0,Todas,0,124857
2021-12-20,30,0,0,Todas,0,124887
2021-12-21,33,0,0,Todas,0,124920
2021-12-22,38,0,0,Todas,0,124958
2021-12-23,30,0,0,Todas,0,124988
2021-12-24,1,0,0,Todas,0,124989
2021-12-25,3,0,0,Todas,0,124992
2021-12-26,1,0,0,Todas,0,124993
2021-12-27,26,0,0,Todas,0,125019
2021-12-28,29,0,0,Todas,0,125048
2021-12-29,37,0,0,Todas,0,125085
2021-12-30,20,0,0,Todas,0,125105
2021-12-31,3,0,0,Todas,0,125108
2022-01-01,3,0,0,Todas,0,125111
2022-01-02,3,0,0,Todas,0,125114
2022-01-03,26,0,0,Todas,0,125140
2022-01-04,26,0,0,Todas,0,125166
2022-01-05,31,0,0,Todas,0,125197
2022-01-06,33,0,0,Todas,0,125230
2022-01-07,46,0,0,Todas,0,125276
2022-01-08,3,0,0,Todas,0,125279
2022-01-10,32,0,0,Todas,0,125311
2022-01-11,35,0,0,Todas,0,125346
2022-01-12,46,0,0,Todas,0,125392
2022-01-13,37,0,0,Todas,0,125429
2022-01-14,32,0,0,Todas,0,125461
2022-01-15,2,0,0,Todas,0,125463
2022-01-16,8,0,0,Todas,0,125471
2022-01-17,27,0,0,Todas,0,125498
2022-01-18,26,0,0,Todas,0,125524
2022-01-19,39,0,0,Todas,0,125563
2022-01-20,26,0,0,Todas,0,125589
2022-01-21,39,0,0,Todas,0,125628
2022-01-22,4,0,0,Todas,0,125632
2022-01-23,1,0,0,Todas,0,125633
2022-01-24,31,0,0,Todas,0,125664
2022-01-25,43,0,0,Todas,0,125707
2022-01-26,36,0,0,Todas,0,125743
2022-01-27,23,0,0,Todas,0,125766
2022-01-28,40,0,0,Todas,0,125806
2022-01-29,5,0,0,Todas,0,125811
2022-01-30,7,0,0,Todas,0,125818
2022-01-31,38,0,0,Todas,0,125856
2022-02-01,42,0,0,Todas,0,125898
2022-02-02,27,0,0,Todas,0,125925
2022-02-03,28,0,0,Todas,0,125953
2022-02-04,22,0,0,Todas,0,125975
2022-02-05,3,0,0,Todas,0,125978
2022-02-06,3,0,0,Todas,0,125981
2022-02-07,41,0,0,Todas,0,126022
2022-02-08,37,0,0,Todas,0,126059
2022-02-09,33,0,0,Todas,0,126092
2022-02-10,24,0,0,Todas,0,126116
2022-02-11,38,0,0,Todas,0,126154
2022-02-12,4,0,0,Todas,0,126158
2022-02-13,2,0,0,Todas,0,126160
2022-02-14,41,0,0,Todas,0,126201
2022-02-15,36,0,0,Todas,0,126237
2022-02-16,37,0,0,Todas,0,126274
2022-02-17,43,0,0,Todas,0,126317
2022-02-18,31,0,0,Todas,0,126348
2022-02-19,4,0,0,Todas,0,126352
2022-02-20,6,0,0,Todas,0,126358
2022-02-21,31,0,0,Todas,0,126389
2022-02-22,51,0,0,Todas,0,126440
2022-02-23,31,0,0,Todas,0,126471
2022-02-24,33,0,0,Todas,0,126504
2022-02-25,34,0,0,Todas,0,126538
2022-03-01,4,0,0,Todas,0,126542
2022-03-02,38,0,0,Todas,0,126580
2022-03-03,27,0,0,Todas,0,126607
2022-03-04,45,0,0,Todas,0,126652
2022-03-06,1,0,0,Todas,0,126653
2022-03-07,44,0,0,Todas,0,126697
2022-03-08,29,0,0,Todas,0,126726
2022-03-09,38,0,0,Todas,0,126764
2022-03-10,56,0,0,Todas,0,126820
2022-03-11,36,0,0,Todas,0,126856
2022-03-12,8,0,0,Todas,0,126864
2022-03-13,16,0,0,Todas,0,126880
2022-03-14,43,0,0,Todas,0,126923
2022-03-15,36,0,0,Todas,0,126959
2022-03-16,57,0,0,Todas,0,127016
2022-03-17,32,0,0,Todas,0,127048
2022-03-18,43,0,0,Todas,0,127091
2022-03-19,5,0,0,Todas,0,127096
2022-03-20,1,0,0,Todas,0,127097
2022-03-21,43,0,0,Todas,0,127140
2022-03-22,35,0,0,Todas,0,127175
2022-03-23,40,0,0,Todas,0,127215
2022-03-24,40,0,0,Todas,0,127255
2022-03-25,35,0,0,Todas,0,127290
2022-03-26,4,0,0,Todas,0,127294
2022-03-27,6,0,0,Todas,0,127300
2022-03-28,31,0,0,Todas,0,127331
2022-03-29,33,0,0,Todas,0,127364
2022-03-30,34,0,0,Todas,0,127398
2022-03-31,39,0,0,Todas,0,127437
2022-04-01,48,0,0,Todas,0,127485
2022-04-02,7,0,0,Todas,0,127492
2022-04-03,4,0,0,Todas,0,127496
2022-04-04,35,0,0,Todas,0,127531
2022-04-05,41,0,0,Todas,0,127572
2022-04-06,35,0,0,Todas,0,127607
2022-04-07,32,0,0,Todas,0,127639
2022-04-08,32,0,0,Todas,0,127671
2022-04-09,5,0,0,Todas,0,127676
2022-04-10,6,0,0,Todas,0,127682
2022-04-11,29,0,0,Todas,0,127711
2022-04-12,32,0,0,Todas,0,127743
2022-04-13,51,0,0,Todas,0,127794
2022-04-14,33,0,0,Todas,0,127827
2022-04-15,2,0,0,Todas,0,127829
2022-04-16,1,0,0,Todas,0,127830
2022-04-17,4,0,0,Todas,0,127834
2022-04-18,44,0,0,Todas,0,127878
2022-04-19,39,0,0,Todas,0,127917
2022-04-20,30,0,0,Todas,0,127947
2022-04-21,35,0,0,Todas,0,127982
2022-04-22,29,0,0,Todas,0,128011
2022-04-23,2,0,0,Todas,0,128013
2022-04-24,3,0,0,Todas,0,128016
2022-04-25,34,0,0,Todas,0,128050
2022-04-26,34,0,0,Todas,0,128084
2022-04-27,28,0,0,Todas,0,128112
2022-04-28,31,0,0,Todas,0,128143
2022-04-29,21,0,0,Todas,0,128164
2022-04-30,4,0,0,Todas,0,128168
2022-05-01,2,0,0,Todas,0,128170
2022-05-02,1,0,0,Todas,0,128171
2022-05-03,28,0,0,Todas,0,128199
2022-05-04,25,0,0,Todas,0,128224
2022-05-05,47,0,0,Todas,0,128271
2022-05-06,39,0,0,Todas,0,128310
2022-05-07,1,0,0,Todas,0,128311
2022-05-08,1,0,0,Todas,0,128312
2022-05-09,13,0,0,Todas,0,128325
2022-05-10,20,0,0,Todas,0,128345
2022-05-11,40,0,0,Todas,0,128385
2022-05-12,16,0,0,Todas,0,128401
2022-05-13,57,0,0,Todas,0,128458
2022-05-14,3,0,0,Todas,0,128461
2022-05-15,2,0,0,Todas,0,128463
2022-05-16,27,0,0,Todas,0,128490
2022-05-17,23,0,0,Todas,0,128513
2022-05-18,29,0,0,Todas,0,128542
2022-05-19,55,0,0,Todas,0,128597
2022-05-20,21,0,0,Todas,0,128618
2022-05-21,5,0,0,Todas,0,128623
2022-05-22,3,0,0,Todas,0,128626
2022-05-23,10,0,0,Todas,0,128636
2022-05-24,30,0,0,Todas,0,128666
2022-05-25,29,0,0,Todas,0,128695
2022-05-26,32,0,0,Todas,0,128727
2022-05-27,40,0,0,Todas,0,128767
2022-05-28,6,0,0,Todas,0,128773
2022-05-29,2,0,0,Todas,0,128775
2022-05-30,42,0,0,Todas,0,128817
2022-05-31,35,0,0,Todas,0,128852
2022-06-01,38,0,0,Todas,0,128890
2022-06-02,32,0,0,Todas,0,128922
2022-06-03,21,0,0,Todas,0,128943
2022-06-04,1,0,0,Todas,0,128944
2022-06-05,1,0,0,Todas,0,128945
2022-06-06,30,0,0,Todas,0,128975
2022-06-07,54,0,0,Todas,0,129029
2022-06-08,37,0,0,Todas,0,129066
2022-06-09,33,0,0,Todas,0,129099
2022-06-10,17,0,0,Todas,0,129116
2022-06-12,4,0,0,Todas,0,129120
2022-06-13,20,0,0,Todas,0,129140
2022-06-14,33,0,0,Todas,0,129173
2022-06-15,50,0,0,Todas,0,129223
2022-06-16,39,0,0,Todas,0,129262
2022-06-17,25,0,0,Todas,0,129287
2022-06-18,5,0,0,Todas,0,129292
2022-06-19,2,0,0,Todas,0,129294
2022-06-20,18,0,0,Todas,0,129312
2022-06-21,16,0,0,Todas,0,129328
2022-06-22,24,0,0,Todas,0,129352
2022-06-23,25,0,0,Todas,0,129377
2022-06-24,20,0,0,Todas,0,129397
2022-06-25,2,0,0,Todas,0,129399
2022-06-26,5,0,0,Todas,0,129404
2022-06-27,32,0,0,Todas,0,129436
2022-06-28,29,0,0,Todas,0,129465
2022-06-29,30,0,0,Todas,0,129495
2022-06-30,24,0,0,Todas,0,129519
2022-07-01,25,0,0,Todas,0,129544
2022-07-03,3,0,0,Todas,0,129547
2022-07-04,58,0,0,Todas,0,129605
2022-07-05,28,0,0,Todas,0,129633
2022-07-06,24,0,0,Todas,0,129657
2022-07-07,29,0,0,Todas,0,129686
2022-07-08,21,0,0,Todas,0,129707
2022-07-11,33,0,0,Todas,0,129740
2022-07-12,30,0,0,Todas,0,129770
2022-07-13,14,0,0,Todas,0,129784
2022-07-14,14,0,0,Todas,0,129798
2022-07-15,13,0,0,Todas,0,129811
2022-07-16,9,0,0,Todas,0,129820
2022-07-17,8,0,0,Todas,0,129828
2022-07-18,38,0,0,Todas,0,129866
2022-07-19,27,0,0,Todas,0,129893
2022-07-20,41,0,0,Todas,0,129934
2022-07-21,28,0,0,Todas,0,129962
2022-07-22,23,0,0,Todas,0,129985
2022-07-23,3,0,0,Todas,0,129988
2022-07-24,5,0,0,Todas,0,129993
2022-07-25,48,0,0,Todas,0,130041
2022-07-26,32,0,0,Todas,0,130073
2022-07-27,37,0,0,Todas,0,130110
2022-07-28,30,0,0,Todas,0,130140
2022-07-29,30,0,0,Todas,0,130170
2022-07-30,1,0,0,Todas,0,130171
2022-07-31,2,0,0,Todas,0,130173
2022-08-01,25,0,0,Todas,0,130198
2022-08-02,39,0,0,Todas,0,130237
2022-08-03,28,0,0,Todas,0,130265
2022-08-04,31,0,0,Todas,0,130296
2022-08-05,32,0,0,Todas,0,130328
2022-08-06,4,0,0,Todas,0,130332
2022-08-07,4,0,0,Todas,0,130336
2022-08-08,32,0,0,Todas,0,130368
2022-08-09,30,0,0,Todas,0,130398
2022-08-10,34,0,0,Todas,0,130432
2022-08-11,22,0,0,Todas,0,130454
2022-08-12,2,0,0,Todas,0,130456
2022-08-13,2,0,0,Todas,0,130458
2022-08-14,4,0,0,Todas,0,130462
2022-08-15,35,0,0,Todas,0,130497
2022-08-16,28,0,0,Todas,0,130525
2022-08-17,32,0,0,Todas,0,130557
2022-08-18,26,0,0,Todas,0,130583
2022-08-19,35,0,0,Todas,0,130618
2022-08-20,6,0,0,Todas,0,130624
2022-08-21,3,0,0,Todas,0,130627
2022-08-22,32,0,0,Todas,0,130659
2022-08-23,34,0,0,Todas,0,130693
2022-08-24,42,0,0,Todas,0,130735
2022-08-25,34,0,0,Todas,0,130769
2022-08-26,38,0,0,Todas,0,130807
2022-08-27,3,0,0,Todas,0,130810
2022-08-28,5,0,0,Todas,0,130815
2022-08-29,20,0,0,Todas,0,130835
2022-08-30,32,0,0,Todas,0,130867
2022-08-31,22,0,0,Todas,0,130889
2022-09-01,42,0,0,Todas,0,130931
2022-09-02,12,0,0,Todas,0,130943
2022-09-05,34,0,0,Todas,0,130977
2022-09-06,28,0,0,Todas,0,131005
2022-09-07,40,0,0,Todas,0,131045
2022-09-08,26,0,0,Todas,0,131071
2022-09-09,34,0,0,Todas,0,131105
2022-09-10,2,0,0,Todas,0,131107
2022-09-11,6,0,0,Todas,0,131113
2022-09-12,27,0,0,Todas,0,131140
2022-09-13,51,0,0,Todas,0,131191
2022-09-14,23,0,0,Todas,0,131214
2022-09-15,35,0,0,Todas,0,131249
2022-09-16,35,0,0,Todas,0,131284
2022-09-17,2,0,0,Todas,0,131286
2022-09-18,5,0,0,Todas,0,131291
2022-09-19,32,0,0,Todas,0,131323
2022-09-20,44,0,0,Todas,0,131367
2022-09-21,55,0,0,Todas,0,131422
2022-09-22,44,0,0,Todas,0,131466
2022-09-23,29,0,0,Todas,0,131495
2022-09-25,1,0,0,Todas,0,131496
2022-09-26,24,0,0,Todas,0,131520
2022-09-27,30,0,0,Todas,0,131550
2022-09-28,35,0,0,Todas,0,131585
2022-09-29,50,0,0,Todas,0,131635
2022-09-30,26,0,0,Todas,0,131661
2022-10-01,1,0,0,Todas,0,131662
2022-10-02,1,0,0,Todas,0,131663
2022-10-03,40,0,0,Todas,0,131703
2022-10-04,29,0,0,Todas,0,131732
2022-10-05,51,0,0,Todas,0,131783
2022-10-06,47,0,0,Todas,0,131830
2022-10-07,42,0,0,Todas,0,131872
2022-10-08,5,0,0,Todas,0,131877
2022-10-09,1,0,0,Todas,0,131878
2022-10-10,7,0,0,Todas,0,131885
2022-10-11,43,0,0,Todas,0,131928
2022-10-12,49,0,0,Todas,0,131977
2022-10-13,33,0,0,Todas,0,132010
2022-10-14,48,0,0,Todas,0,132058
2022-10-15,2,0,0,Todas,0,132060
2022-10-16,3,0,0,Todas,0,132063
2022-10-17,41,0,0,Todas,0,132104
2022-10-18,41,0,0,Todas,0,132145
2022-10-19,32,0,0,Todas,0,132177
2022-10-20,48,0,0,Todas,0,132225
2022-10-21,39,0,0,Todas,0,132264
2022-10-22,2,0,0,Todas,0,132266
2022-10-24,37,0,0,Todas,0,132303
2022-10-25,49,0,0,Todas,0,132352
2022-10-26,44,0,0,Todas,0,132396
2022-10-27,56,0,0,Todas,0,132452
2022-10-28,49,0,0,Todas,0,132501
2022-10-31,32,0,0,Todas,0,132533
2022-11-01,46,0,0,Todas,0,132579
2022-11-02,43,0,0,Todas,0,132622
2022-11-03,7,0,0,Todas,0,132629
2022-11-05,2,0,0,Todas,0,132631
2022-11-06,4,0,0,Todas,0,132635
2022-11-07,62,0,0,Todas,0,132697
2022-11-08,54,0,0,Todas,0,132751
2022-11-09,56,0,0,Todas,0,132807
2022-11-10,66,0,0,Todas,0,132873
2022-11-11,63,0,0,Todas,0,132936
2022-11-12,1,0,0,Todas,0,132937
2022-11-13,1,0,0,Todas,0,132938
2022-11-14,40,0,0,Todas,0,132978
2022-11-15,49,0,0,Todas,0,133027
2022-11-16,47,0,0,Todas,0,133074
2022-11-17,40,0,0,Todas,0,133114
2022-11-18,46,0,0,Todas,0,133160
2022-11-19,3,0,0,Todas,0,133163
2022-11-20,2,0,0,Todas,0,133165
2022-11-21,41,0,0,Todas,0,133206
2022-11-22,33,0,0,Todas,0,133239
2022-11-23,39,0,0,Todas,0,133278
2022-11-24,46,0,0,Todas,0,133324
2022-11-25,33,0,0,Todas,0,133357
2022-11-26,2,0,0,Todas,0,133359
2022-11-27,4,0,0,Todas,0,133363
2022-11-28,37,0,0,Todas,0,133400
2022-11-29,34,0,0,Todas,0,133434
2022-11-30,26,0,0,Todas,0,133460
2022-12-01,44,0,0,Todas,0,133504
2022-12-02,44,0,0,Todas,0,133548
2022-12-03,2,0,0,Todas,0,133550
2022-12-04,1,0,0,Todas,0,133551
2022-12-05,8,0,0,Todas,0,133559
2022-12-06,45,0,0,Todas,0,133604
2022-12-07,41,0,0,Todas,0,133645
2022-12-08,39,0,0,Todas,0,133684
2022-12-09,40,0,0,Todas,0,133724
2022-12-10,2,0,0,Todas,0,133726
2022-12-12,36,0,0,Todas,0,133762
2022-12-13,27,0,0,Todas,0,133789
2022-12-14,31,0,0,Todas,0,133820
2022-12-15,37,0,0,Todas,0,133857
2022-12-16,31,0,0,Todas,0,133888
2022-12-17,3,0,0,Todas,0,133891
2022-12-18,1,0,0,Todas,0,133892
2022-12-19,30,0,0,Todas,0,133922
2022-12-20,31,0,0,Todas,0,133953
2022-12-21,40,0,0,Todas,0,133993
2022-12-22,26,0,0,Todas,0,134019
2022-12-23,24,0,0,Todas,0,134043
2022-12-24,4,0,0,Todas,0,134047
2022-12-26,5,0,0,Todas,0,134052
2022-12-27,35,0,0,Todas,0,134087
2022-12-28,33,0,0,Todas,0,134120
2022-12-29,36,0,0,Todas,0,134156
2022-12-30,18,0,0,Todas,0,134174
2023-01-02,3,0,0,Todas,0,134177
2023-01-03,34,0,0,Todas,0,134211
2023-01-04,33,0,0,Todas,0,134244
2023-01-05,24,0,0,Todas,0,134268
2023-01-06,33,0,0,Todas,0,134301
2023-01-09,47,0,0,Todas,0,134348
2023-01-10,44,0,0,Todas,0,134392
2023-01-11,47,0,0,Todas,0,134439
2023-01-12,37,0,0,Todas,0,134476
2023-01-13,30,0,0,Todas,0,134506
2023-01-14,6,0,0,Todas,0,134512
2023-01-15,7,0,0,Todas,0,134519
2023-01-16,32,0,0,Todas,0,134551
2023-01-17,38,0,0,Todas,0,134589
2023-01-18,36,0,0,Todas,0,134625
2023-01-19,42,0,0,Todas,0,134667
2023-01-20,34,0,0,Todas,0,134701
2023-01-21,2,0,0,Todas,0,134703
2023-01-22,4,0,0,Todas,0,134707
2023-01-23,31,0,0,Todas,0,134738
2023-01-24,38,0,0,Todas,0,134776
2023-01-25,30,0,0,Todas,0,134806
2023-01-26,39,0,0,Todas,0,134845
2023-01-27,44,0,0,Todas,0,134889
2023-01-28,2,0,0,Todas,0,134891
2023-01-29,4,0,0,Todas,0,134895
2023-01-30,39,0,0,Todas,0,134934
2023-01-31,41,0,0,Todas,0,134975
2023-02-01,43,0,0,Todas,0,135018
2023-02-02,44,0,0,Todas,0,135062
2023-02-03,36,0,0,Todas,0,135098
2023-02-04,2,0,0,Todas,0,135100
2023-02-05,2,0,0,Todas,0,135102
2023-02-06,13,0,0,Todas,0,135115
2023-02-07,40,0,0,Todas,0,135155
2023-02-08,25,0,0,Todas,0,135180
2023-02-09,36,0,0,Todas,0,135216
2023-02-10,30,0,0,Todas,0,135246
2023-02-13,32,0,0,Todas,0,135278
2023-02-14,51,0,0,Todas,0,135329
2023-02-15,31,0,0,Todas,0,135360
2023-02-16,23,0,0,Todas,0,135383
2023-02-17,39,0,0,Todas,0,135422
2023-02-20,3,0,0,Todas,0,135425
2023-02-21,2,0,0,Todas,0,135427
2023-02-22,24,0,0,Todas,0,135451
2023-02-23,33,0,0,Todas,0,135484
2023-02-24,39,0,0,Todas,0,135523
2023-02-25,5,0,0,Todas,0,135528
2023-02-26,3,0,0,Todas,0,135531
2023-02-27,41,0,0,Todas,0,135572
2023-02-28,30,0,0,Todas,0,135602
2023-03-01,46,0,0,Todas,0,135648
2023-03-02,37,0,0,Todas,0,135685
2023-03-03,44,0,0,Todas,0,135729
2023-03-04,1,0,0,Todas,0,135730
2023-03-05,5,0,0,Todas,0,135735
2023-03-06,45,0,0,Todas,0,135780
2023-03-07,38,0,0,Todas,0,135818
2023-03-08,41,0,0,Todas,0,135859
2023-03-09,32,0,0,Todas,0,135891
2023-03-10,26,0,0,Todas,0,135917
2023-03-11,7,0,0,Todas,0,135924
2023-03-12,5,0,0,Todas,0,135929
2023-03-13,30,0,0,Todas,0,135959
2023-03-14,23,0,0,Todas,0,135982
2023-03-15,33,0,0,Todas,0,136015
2023-03-16,25,0,0,Todas,0,136040
2023-03-17,33,0,0,Todas,0,136073
2023-03-18,3,0,0,Todas,0,136076
2023-03-19,7,0,0,Todas,0,136083
2023-03-20,35,0,0,Todas,0,136118
2023-03-21,27,0,0,Todas,0,136145
2023-03-22,39,0,0,Todas,0,136184
2023-03-23,29,0,0,Todas,0,136213
2023-03-24,27,0,0,Todas,0,136240
2023-03-25,8,0,0,Todas,0,136248
2023-03-26,7,0,0,Todas,0,136255
2023-03-27,28,0,0,Todas,0,136283
2023-03-28,29,0,0,Todas,0,136312
2023-03-29,45,0,0,Todas,0,136357
2023-03-30,36,0,0,Todas,0,136393
2023-03-31,28,0,0,Todas,0,136421
2023-04-01,6,0,0,Todas,0,136427
2023-04-02,4,0,0,Todas,0,136431
2023-04-03,32,0,0,Todas,0,136463
2023-04-04,34,0,0,Todas,0,136497
2023-04-05,50,0,0,Todas,0,136547
2023-04-06,32,0,0,Todas,0,136579
2023-04-07,2,0,0,Todas,0,136581
2023-04-08,1,0,0,Todas,0,136582
2023-04-09,1,0,0,Todas,0,136583
2023-04-10,38,0,0,Todas,0,136621
2023-04-11,37,0,0,Todas,0,136658
2023-04-12,38,0,0,Todas,0,136696
2023-04-13,38,0,0,Todas,0,136734
2023-04-14,35,0,0,Todas,0,136769
2023-04-15,4,0,0,Todas,0,136773
2023-04-16,4,0,0,Todas,0,136777
2023-04-17,35,0,0,Todas,0,136812
2023-04-18,36,0,0,Todas,0,136848
2023-04-19,45,0,0,Todas,0,136893
2023-04-20,38,0,0,Todas,0,136931
2023-04-21,33,0,0,Todas,0,136964
2023-04-22,5,0,0,Todas,0,136969
2023-04-23,6,0,0,Todas,0,136975
2023-04-24,38,0,0,Todas,0,137013
2023-04-25,25,0,0,Todas,0,137038
2023-04-26,22,0,0,Todas,0,137060
2023-04-27,30,0,0,Todas,0,137090
2023-04-28,11,0,0,Todas,0,137101
2023-04-29,1,0,0,Todas,0,137102
2023-05-01,10,0,0,Todas,0,137112
2023-05-02,32,0,0,Todas,0,137144
2023-05-03,40,0,0,Todas,0,137184
2023-05-04,39,0,0,Todas,0,137223
2023-05-05,31,0,0,Todas,0,137254
2023-05-08,34,0,0,Todas,0,137288
2023-05-09,29,0,0,Todas,0,137317
2023-05-10,50,0,0,Todas,0,137367
2023-05-11,24,0,0,Todas,0,137391
2023-05-12,25,0,0,Todas,0,137416
2023-05-13,4,0,0,Todas,0,137420
2023-05-15,33,0,0,Todas,0,137453
2023-05-16,33,0,0,Todas,0,137486
2023-05-17,39,0,0,Todas,0,137525
2023-05-18,43,0,0,Todas,0,137568
2023-05-19,31,0,0,Todas,0,137599
2023-05-20,3,0,0,Todas,0,137602
2023-05-21,6,0,0,Todas,0,137608
2023-05-22,30,0,0,Todas,0,137638
2023-05-23,52,0,0,Todas,0,137690
2023-05-24,35,0,0,Todas,0,137725
2023-05-25,29,0,0,Todas,0,137754
2023-05-26,1,0,0,Todas,0,137755
2023-05-27,1,0,0,Todas,0,137756
2023-05-29,39,0,0,Todas,0,137795
2023-05-30,32,0,0,Todas,0,137827
2023-05-31,33,0,0,Todas,0,137860
2023-06-01,34,0,0,Todas,0,137894
2023-06-02,25,0,0,Todas,0,137919
2023-06-03,6,0,0,Todas,0,137925
2023-06-04,2,0,0,Todas,0,137927
2023-06-05,32,0,0,Todas,0,137959
2023-06-06,35,0,0,Todas,0,137994
2023-06-07,43,0,0,Todas,0,138037
2023-06-08,18,0,0,Todas,0,138055
2023-06-09,49,0,0,Todas,0,138104
2023-06-10,4,0,0,Todas,0,138108
2023-06-11,1,0,0,Todas,0,138109
2023-06-12,40,0,0,Todas,0,138149
2023-06-13,39,0,0,Todas,0,138188
2023-06-14,29,0,0,Todas,0,138217
2023-06-15,37,0,0,Todas,0,138254
2023-06-16,23,0,0,Todas,0,138277
2023-06-17,1,0,0,Todas,0,138278
2023-06-18,4,0,0,Todas,0,138282
2023-06-19,33,0,0,Todas,0,138315
2023-06-20,33,0,0,Todas,0,138348
2023-06-21,32,0,0,Todas,0,138380
2023-06-22,29,0,0,Todas,0,138409
2023-06-23,19,0,0,Todas,0,138428
2023-06-24,12,0,0,Todas,0,138440
2023-06-25,5,0,0,Todas,0,138445
2023-06-26,33,0,0,Todas,0,138478
2023-06-27,40,0,0,Todas,0,138518
2023-06-28,25,0,0,Todas,0,138543
2023-06-29,36,0,0,Todas,0,138579
2023-06-30,36,0,0,Todas,0,138615
2023-07-03,38,0,0,Todas,0,138653
2023-07-04,36,0,0,Todas,0,138689
2023-07-05,45,0,0,Todas,0,138734
2023-07-06,39,0,0,Todas,0,138773
2023-07-07,43,0,0,Todas,0,138816
2023-07-08,1,0,0,Todas,0,138817
2023-07-09,3,0,0,Todas,0,138820
2023-07-10,41,0,0,Todas,0,138861
2023-07-11,37,0,0,Todas,0,138898
2023-07-12,39,0,0,Todas,0,138937
2023-07-13,32,0,0,Todas,0,138969
2023-07-14,40,0,0,Todas,0,139009
2023-07-15,2,0,0,Todas,0,139011
2023-07-16,5,0,0,Todas,0,139016
2023-07-17,34,0,0,Todas,0,139050
2023-07-18,44,0,0,Todas,0,139094
2023-07-19,47,0,0,Todas,0,139141
2023-07-20,44,0,0,Todas,0,139185
2023-07-21,24,0,0,Todas,0,139209
2023-07-22,3,0,0,Todas,0,139212
2023-07-23,4,0,0,Todas,0,139216
2023-07-24,22,0,0,Todas,0,139238
2023-07-25,38,0,0,Todas,0,139276
2023-07-26,29,0,0,Todas,0,139305
2023-07-27,39,0,0,Todas,0,139344
2023-07-28,27,0,0,Todas,0,139371
2023-07-31,46,0,0,Todas,0,139417
2023-08-01,26,0,0,Todas,0,139443
2023-08-02,28,0,0,Todas,0,139471
2023-08-03,32,0,0,Todas,0,139503
2023-08-04,36,0,0,Todas,0,139539
2023-08-06,1,0,0,Todas,0,139540
2023-08-07,38,0,0,Todas,0,139578
2023-08-08,36,0,0,Todas,0,139614
2023-08-09,42,0,0,Todas,0,139656
2023-08-10,40,0,0,Todas,0,139696
2023-08-11,1,0,0,Todas,0,139697
2023-08-13,3,0,0,Todas,0,139700
2023-08-14,17,0,0,Todas,0,139717
2023-08-15,27,0,0,Todas,0,139744
2023-08-16,40,0,0,Todas,0,139784
2023-08-17,30,0,0,Todas,0,139814
2023-08-18,23,0,0,Todas,0,139837
2023-08-21,23,0,0,Todas,0,139860
2023-08-22,39,0,0,Todas,0,139899
2023-08-23,38,0,0,Todas,0,139937
2023-08-24,43,0,0,Todas,0,139980
2023-08-25,34,0,0,Todas,0,140014
2023-08-26,7,0,0,Todas,0,140021
2023-08-27,1,0,0,Todas,0,140022
2023-08-28,33,0,0,Todas,0,140055
2023-08-29,32,0,0,Todas,0,140087
2023-08-30,22,0,0,Todas,0,140109
2023-08-31,29,0,0,Todas,0,140138
2023-09-01,30,0,0,Todas,0,140168
2023-09-02,3,0,0,Todas,0,140171
2023-09-03,2,0,0,Todas,0,140173
2023-09-04,26,0,0,Todas,0,140199
2023-09-05,40,0,0,Todas,0,140239
2023-09-06,30,0,0,Todas,0,140269
2023-09-07,35,0,0,Todas,0,140304
2023-09-08,35,0,0,Todas,0,140339
2023-09-10,1,0,0,Todas,0,140340
2023-09-11,33,0,0,Todas,0,140373
2023-09-12,25,0,0,Todas,0,140398
2023-09-13,48,0,0,Todas,0,140446
2023-09-14,29,0,0,Todas,0,140475
2023-09-15,33,0,0,Todas,0,140508
2023-09-16,1,0,0,Todas,0,140509
2023-09-18,38,0,0,Todas,0,140547
2023-09-19,30,0,0,Todas,0,140577
2023-09-20,38,0,0,Todas,0,140615
2023-09-21,29,0,0,Todas,0,140644
2023-09-22,27,0,0,Todas,0,140671
2023-09-23,6,0,0,Todas,0,140677
2023-09-24,4,0,0,Todas,0,140681
2023-09-25,28,0,0,Todas,0,140709
2023-09-26,40,0,0,Todas,0,140749
2023-09-27,40,0,0,Todas,0,140789
2023-09-28,48,0,0,Todas,0,140837
2023-09-29,32,0,0,Todas,0,140869
2023-09-30,2,0,0,Todas,0,140871
2023-10-01,6,0,0,Todas,0,140877
2023-10-02,19,0,0,Todas,0,140896
2023-10-03,30,0,0,Todas,0,140926
2023-10-04,47,0,0,Todas,0,140973
2023-10-05,39,0,0,Todas,0,141012
2023-10-06,42,0,0,Todas,0,141054
2023-10-07,1,0,0,Todas,0,141055
2023-10-08,2,0,0,Todas,0,141057
2023-10-09,7,0,0,Todas,0,141064
2023-10-10,30,0,0,Todas,0,141094
2023-10-11,36,0,0,Todas,0,141130
2023-10-12,36,0,0,Todas,0,141166
2023-10-13,31,0,0,Todas,0,141197
2023-10-14,7,0,0,Todas,0,141204
2023-10-15,5,0,0,Todas,0,141209
2023-10-16,27,0,0,Todas,0,141236
2023-10-17,26,0,0,Todas,0,141262
2023-10-18,30,0,0,Todas,0,141292
2023-10-19,27,0,0,Todas,0,141319
2023-10-20,23,0,0,Todas,0,141342
2023-10-21,9,0,0,Todas,0,141351
2023-10-22,4,0,0,Todas,0,141355
2023-10-23,34,0,0,Todas,0,141389
2023-10-24,28,0,0,Todas,0,141417
2023-10-25,44,0,0,Todas,0,141461
2023-10-26,32,0,0,Todas,0,141493
2023-10-27,41,0,0,Todas,0,141534
2023-10-28,1,0,0,Todas,0,141535
2023-10-29,5,0,0,Todas,0,141540
2023-10-30,25,0,0,Todas,0,141565
2023-10-31,37,0,0,Todas,0,141602
2023-11-01,28,0,0,Todas,0,141630
2023-11-02,4,0,0,Todas,0,141634
2023-11-03,2,0,0,Todas,0,141636
2023-11-04,3,0,0,Todas,0,141639
2023-11-05,2,0,0,Todas,0,141641
2023-11-06,22,0,0,Todas,0,141663
2023-11-07,33,0,0,Todas,0,141696
2023-11-08,28,0,0,Todas,0,141724
2023-11-09,38,0,0,Todas,0,141762
2023-11-10,42,0,0,Todas,0,141804
2023-11-12,2,0,0,Todas,0,141806
2023-11-13,38,0,0,Todas,0,141844
2023-11-14,29,0,0,Todas,0,141873
2023-11-15,35,0,0,Todas,0,141908
2023-11-16,35,0,0,Todas,0,141943
2023-11-17,29,0,0,Todas,0,141972
2023-11-19,3,0,0,Todas,0,141975
2023-11-20,26,0,0,Todas,0,142001
2023-11-21,46,0,0,Todas,0,142047
2023-11-22,26,0,0,Todas,0,142073
2023-11-23,32,0,0,Todas,0,142105
2023-11-24,24,0,0,Todas,0,142129
2023-11-25,3,0,0,Todas,0,142132
2023-11-26,6,0,0,Todas,0,142138
2023-11-27,29,0,0,Todas,0,142167
2023-11-28,38,0,0,Todas,0,142205
2023-11-29,37,0,0,Todas,0,142242
2023-11-30,18,0,0,Todas,0,142260
